EPIC — OFFICE DU TOURISME	EPIC OFFICE DU TOURISME	96
CPCU — COMPAGNIE PARISIENNE DE CHAUFFAGE URBAIN	CPCU COMPAGNIE PARISIENNE DE CHAUFFAGE URBAIN	98
DIR CENTRE EST	DIR CENTRE-EST	100
VAL' HAINAUT HABITAT	VAL HAINAUT HABITAT	97
COMMUNAUTÉ D'AGGLOMÉRATION DE PAU PYRÉNÉES	COMMUNAUTÉ D'AGGLOMÉRATION DE PAU-PYRÉNÉES	100
VILLE DE CALUIRE ET CUIRE	VILLE DE CALUIRE-ET-CUIRE	100
MINDEF/ARMÉE DE L'AIR/SIMMAD/SSAM33503	MINDEF/ARMÉE DE L'AIR/SIMMAD/SSAM 33503	99
CONSEIL GÉNÉRAL D'INDRE-ET-LOIRE	CONSEIL GÉNÉRAL D'INDRE ET LOIRE	100
DÉPARTEMENT DU VAL-DE-MARNE	DÉPARTEMENT DU VAL DE MARNE	100
CA PORTES DE FRANCE-THIONVILLE	CA PORTES DE FRANCE — THIONVILLE	97
DÉPARTEMENT DES RECHERCHES ARCHÉOLOGIQUES	DÉPARTEMENT DES RECHERCHES ARCHÉOLOGIQUE	99
ARTOIS COMM.	ARTOIS COMM	100
IMMOBILIÈRE 3F	IMMOBILIERE 3F	96
ASSOCIATION FRANCAISE DE NORMALISATION: AFNOR	ASSOCIATION FRANÇAISE DE NORMALISATION: AFNOR	99
GPM DE NANTES-SAINT-NAZAIRE	GPM DE NANTES — SAINT-NAZAIRE	96
SNCF RÉSEAU INGÉNIERIE ET PROJETS — AGENCE RHÔNE-ALPES AUVERGNE, REPRÉSENTÉE PAR SETEC ORGANISATION, EN SA QUALITÉ DE MANDATAIRE DE MAÎTRISE D'OUVRAGE	SNCF RÉSEAU INGÉNIERIE & PROJETS AGENCE RHÔNE-ALPES AUVERGNE, REPRÉSENTÉE PAR SETEC ORGANISATION, EN SA QUALITÉ DE MANDATAIRE DE MAÎTRISE D'OUVRAGE	98
CARSAT RHÔNE-ALPES	CARSAT RHÔNE ALPES	100
COMMISSARIAT À L'ÉNERGIE ATOMIQUE ET AUX ÉNERGIES ALTERNATIVES — CEA/SACLAY	COMMISSARIAT A L'ÉNERGIE ATOMIQUE ET AUX ÉNERGIES ALTERNATIVES — CEA/SACLAY	99
VILLE DE MONT DE MARSAN	VILLE DE MONT-DE-MARSAN	100
ŒUVRE DU PERPÉTUEL SECOURS IHFB	ŒUVRE DU PERPÉTUEL SECOURS — IHFB	97
ÉTABLISSEMENT SNI GRAND-OUEST	ÉTABLISSEMENT SNI GRAND OUEST	100
ESCOTA — SOCIETÉ DES AUTOROUTES ESTÉREL, CÔTE D'AZUR, PROVENCE, ALPES	ESCOTA — SOCIÉTÉ DES AUTOROUTES ESTÉREL, CÔTE D'AZUR, PROVENCE, ALPES	99
ASSISTANCE PUBLIQUE HÔPITAUX DE PARIS	ASSISTANCE PUBLIQUE-HÔPITAUX DE PARIS	100
CHI — VILLENEUVE-SAINT-GEORGES	CHI VILLENEUVE-SAINT GEORGES	97
CHU AMIENS-PICARDIE	CHU AMIENS PICARDIE	100
HOPITAL SAINTE-ANNE	HÔPITAL SAINTE-ANNE	97
COMMUNAUTÉ D'AGGLOMÉRATION DE CHARLEVILLE-MÉZIÈRES / SEDAN	COMMUNAUTÉ D’AGGLOMÉRATION CHARLEVILLE-MÉZIÈRES / SEDAN	97
INSTITUT GEOGRAPHIQUE NATIONAL	INSTITUT GÉOGRAPHIQUE NATIONAL	98
CENTRE RÉGIONAL ŒUVRES UNIV. SCOLAIRES	CENTRE RÉGIONAL OEUVRES UNIV. SCOLAIRES	96
EDF PRODUCTION ÉLECTRIQUE INSULAIRE SAS (EDF PEI)	EDF PRODUCTION ÉLECTRIQUE INSULAIRE (EDF PEI)	96
COMMUNAUTÉ D'AGGLOMÉRATION LOIRE FOREZ	COMMUNAUTÉ D'AGGLOMÉRATION LOIRE-FOREZ	100
VILLE DE SAINT-GRÉGOIRE	VILLE DE SAINT GRÉGOIRE	100
UNIVERSITÉ PARIS OUEST NANTERRE	UNIVERSITÉ PARIS-OUEST-NANTERRE	100
COMMUNAUTÉ D'AGGLOMÈRATION DU LAC DU BOURGET	COMMUNAUTÉ D'AGGLOMÉRATION DU LAC DU BOURGET	100
ALSACE CHAMPAGNE-ARDENNE LORRAINE	ALSACE-CHAMPAGNE-ARDENNE-LORRAINE	100
CONSEIL GENERAL DE L'ARIÈGE	CONSEIL GÉNÉRAL DE L'ARIÈGE	96
NIÈVRE HABITAT	NIEVRE HABITAT	96
UNIVERSITÉ FRANÇOIS-RABELAIS DE TOURS	UNIVERSITÉ FRANÇOIS RABELAIS DE TOURS	100
GROUPE HOSPITALIER SECLIN-CARVIN	GROUPE HOSPITALIER SECLIN CARVIN	100
CNRS — DÉLÉGATION MIDI-PYRÉNÉES	CNRS — DÉLÉGATION MIDI PYRÉNÉES	100
VILLE D'ANTIBES — JUAN-LES-PINS	VILLE D'ANTIBES JUAN-LES-PINS	97
CENTRALESUPELEC	CENTRALE SUPELEC	97
COMMISSARIAT A L'ÉNERGIE ATOMIQUE ET AUX ÉNERGIES ALTERNATIVES — CEA/SACLAY	COMMISSARIAT À L'ÉNERGIE ATOMIQUE ET AUX ÉNERGIES ALTERNATIVES — CEA/SACLAY	99
UNIVERSITÉ TOULOUSE 1 SCIENCES SOCIALE	UNIVERSITÉ TOULOUSE 1, SCIENCES SOCIALE	99
LA POSTE — DIRECTION GÉNÉRALE DU RÉSEAU	LA POSTE – DIRECTION GÉNÉRALE DU RÉSEAU	100
MINISTÈRE DE LA DÉFENSE — BCAC-CG195/M	MINISTÈRE DE LA DÉFENSE — BCAC-CG 195/M	99
CHI ELBEUF LOUVIERS/VAL DE REUIL	CHI ELBEUF-LOUVIERS / VAL DE REUIL	97
CA PORTES DE FRANCE — THIONVILLE	CA PORTES DE FRANCE-THIONVILLE	97
COMMUNAUTÉ D'AGGLOMÉRATION VAR ESTÉREL MÉDITERRANÉE	COMMUNAUTÉ D’AGGLOMÉRATION VAR ESTÉREL MÉDITERRANÉE	100
MÉTROPOLE AIX-MARSEILLE-PROVENCE CT6	MÉTROPOLE AIX-MARSEILLE-PROVENCE CT 6	99
CTRE NAT. DE LA RECHERCHE SCIENTIFIQUE	CTRE NAT DE LA RECHERCHE SCIENTIFIQUE	99
ÉCOLE NATIONALE SUPÉRIEURE DES ARTS ET MÉTIERS	ÉCOLE NATIONALE SUPÉRIEURE D'ARTS ET MÉTIERS	98
IMMOBILIÈRE 3F — DPRU	IMMOBILIÈRE 3F, DPRU	97
COMMISSARIAT A L'ÉNERGIE ATOMIQUE ET AUX ÉNERGIES ALTERNATIVES (CEA) — FONTENAY-AUX-ROSES	COMMISSARIAT À L'ÉNERGIE ATOMIQUE ET AUX ÉNERGIES ALTERNATIVES (CEA) — FONTENAY-AUX-ROSES	99
COMMUNAUTÉ D'AGGLOMÉRATION DE ST-OMER	COMMUNAUTÉ D'AGGLOMÉRATION DE SAINT-OMER	96
SICTOM ZONE DE LONS LE SAUNIER	SICTOM ZONE DE LONS-LE-SAUNIER	100
GH COCHIN — BROCA- HÔTEL-DIEU	GH COCHIN — BROCA — HÔTEL-DIEU	98
DESTINATION RENNES — TOURISME CONGRÈS	DESTINATION RENNES TOURISME CONGRÈS	97
IEDOM INSTITUT D'ÉMISSION DES DÉPARTEMENTS D'OUTRE-MER	IEDOM — INSTITUT D'ÉMISSION DES DÉPARTEMENTS D'OUTRE-MER	98
SOCIÉTÉ IMMOBILIÈRE DES CHEMINS DE FERS	SOCIÉTÉ IMMOBILIÈRE DES CHEMINS DE FER	99
LANGUEDOC ROUSSILLON AMÉNAGEMENT	LANGUEDOC-ROUSSILLON AMÉNAGEMENT	100
RÉGION NORD-PAS-DE-CALAIS - PICARDIE	RÉGION NORD PAS-DE-CALAIS — PICARDIE	100
CHI ELBEUF-LOUVIERS / VAL DE REUIL	CHI ELBEUF LOUVIERS / VAL DE REUIL	100
COMMUANUTÉ D'AGGLOMÉRATION DU LAC DU BOURGET	COMMUNAUTÉ D'AGGLOMÈRATION DU LAC DU BOURGET	98
PÔLE SANTÉ SARTHE ET LOIRE	PÔLE SANTÉ SARTHE-ET-LOIRE	100
SOCIÉTÉ IMMOBILIÈRE DU DÉPARTEMENT DE LA RÉUNION SOCIÉTÉ ANONYME D'ECONOMIE MIXTE (SEM) CRÉÉE EN APPLICATION DE L'ARTICLE 2 DE LA LOI DU 30.4.1946 AU CAPITAL DE 125 000 000 EUR — RCS ST DENIS N°74 B 118 — SIRET :310 863 592 00013	SOCIÉTÉ IMMOBILIÈRE DU DÉPARTEMENT DE LA RÉUNION SOCIÉTÉ ANONYME D'ÉCONOMIE MIXTE (SEM) CRÉÉE EN APPLICATION DE L'ARTICLE 2 DE LA LOI DU 30.4.1946 AU CAPITAL DE 125 000 000 EUR — RCS ST DENIS N°74 B 118 — SIRET :310 863 592 00013	100
PARIS TERRES D'ENVOL	PARIS, TERRES D'ENVOL	98
COMMUNE DE PLAISANCE-DU-TOUCH	COMMUNE DE PLAISANCE DU TOUCH	100
INSTITUT ROBERT MERLE D'AUBIGNE	INSTITUT ROBERT MERLE D'AUBIGNÉ	98
MAIRIE DE TREMBLAY EN FRANCE	MAIRIE DE TREMBLAY-EN-FRANCE	100
UNIVERSITÉ ÉVRY VAL D'ESSONNE	UNIVERSITÉ ÉVRY-VAL-D'ESSONNE	100
COMMUNAUTÉ D’AGGLOMÉRATION DU PAYS DE MEAUX	COMMUNAUTÉ D'AGGLOMÉRATION DU PAYS DE MEAUX	100
COMMUNAUTÉ DE COMMUNES BRESLE MARITIME	COMMUNAUTÉ DE COMMUNES BRESLE-MARITIME	100
UNIVERSITÉ PARIS 1 PANTHÉON-SORBONNE	UNIVERSITÉ PARIS 1 — PANTHÉON-SORBONNE	97
BLANGY-PONT L'ÉVÊQUE INTERCOM	BLANGY PONT-L'ÉVÊQUE INTERCOM	100
LA CRÉOLE-COMPAGNIE RÉUNIONNAISE EAUX	LA CREOLE-COMPAGNIE RÉUNIONNAISE EAUX	99
OPH ÉMERAUDE HABITATION	OPH EMERAUDE HABITATION	98
CTÉ D'AGGLO. DE PAU PYRÉNÉES	CTÉ D'AGGLO DE PAU PYRÉNÉES	98
RÉGION NORD PAS-DE-CALAIS — PICARDIE	RÉGION NORD-PAS-DE-CALAIS - PICARDIE	100
CHAMBRE DE METIERS ET DE L'ARTISANAT	CHAMBRE DE MÉTIERS ET DE L'ARTISANAT	99
GIE PACA CORSE AU NOM ET POUR LE COMPTE DE LA SNI SUD EST	GIA PACA CPRSE AU NOM ET POUR LE COMPTE DE LA SNI SUD EST	96
SIVOM SAINT-GAUDENS MONTREJEAU ASPET	SIVOM SAINT-GAUDENS MONTRÉJEAU ASPET	99
ENEDIS (ANCIENNEMENT ERDF ÉLECTRICITÉ RÉSEAU DISTRIBUTION FRANCE)	ENEDIS (ANCIENNEMENT ERDF ELECTRICITÉ RÉSEAU DISTRIBUTION FRANCE)	99
POLE SANTÉ SARTHE-ET-LOIRE	PÔLE SANTÉ SARTHE ET LOIRE	98
CHR METZ-THIONVILLE	CHR METZ THIONVILLE	100
CONSEIL GÉNÉRAL DES HAUTS-DE-SEINE	CONSEIL GÉNÉRAL DES HAUTS DE SEINE	100
CONSEIL GÉNÉRAL DE L'ARIÈGE	CONSEIL GENERAL DE L'ARIÈGE	96
MAISONS ET CITES/SOGINORPA	MAISONS ET CITÉS SOGINORPA	98
COMMUNAUTÉ DE COMMUNES CŒUR DE LOZÈRE	COMMUNAUTÉ DE COMMUNES COEUR DE LOZÈRE	96
TERRITOIRE DE LA COTE OUEST	TERRITOIRE DE LA CÔTE OUEST	98
COMMUNE DE PORTET-SUR-GARONNE	COMMUNE DE PORTET SUR GARONNE	100
COMMUNAUTÉ COMMUNES DU CANTON DE MONTLUEL	COMMUNAUTÉ DE COMMUNES DU CANTON DE MONTLUEL	96
ASSISTANCE PUBLIQUE - HÔPITAUX DE PARIS	ASSISTANCE PUBLIQUE — HÔPITAUX DE PARIS	100
COMMUNAUTÉ D'AGGLOMÉRATION DE SAINT-OMER	COMMUNAUTÉ D'AGGLOMÉRATION DE SAINT OMER	100
[LA POSTE] BRANCHE SERVICES-COURRIER-COLIS (BSCC) — FILIALE VIAPOST TRANSPORT MANAGEMENT	[LA POSTE] BRANCHE SERVICES-COURRIER-COLIS (BSCC) FILIALE VIAPOST TRANSPORT MANAGEMENT	99
DEA 976-SIST-UST	DEA976-SIST-UST	97
FONDATION CAISSES D'EPARGNE POUR LA SOLIDARITÉ (FCES)	FONDATION CAISSES D'ÉPARGNE POUR LA SOLIDARITÉ (FCES)	99
COMMUNAUTÉ DE COMMUNES DU VAL-DE-DRÔME	COMMUNAUTÉ DE COMMUNES DU VAL DE DRÔME	100
EP SECURITÉ FERROVIAIRE	EP SÉCURITÉ FERROVIAIRE	98
SIAEAG GUADELOUPE	SIAEA GUADELOUPE	97
SOCIÉTÉ NATIONALE IMMOBILIÈRE — ÉTABLISSEMENT NORD-EST	SOCIÉTÉ NATIONALE IMMOBILIÈRE — ÉTABLISSEMENT NORD EST	100
SA AÉROPORT DE BORDEAUX MÉRIGNAC	SA AÉROPORT DE BORDEAUX-MÉRIGNAC	100
VILLE DU PERREUX-SUR MARNE	VILLE DU PERREUX-SUR-MARNE	100
VILLE DE DEUIL-LA-BARRE	VILLE DE DEUIL LA BARRE	100
SICTOM ZONE DE LONS-LE-SAUNIER	SICTOM ZONE DE LONS LE SAUNIER	100
COMMUNAUTÉ D'AGGLOMÉRATION TOUR(S) PLUS	COMMUNAUTÉ D'AGGLOMÉRATION TOUR(S)PLUS	99
REIMS-HABITAT CHAMPAGNE-ARDENNE	REIMS HABITAT CHAMPAGNE ARDENNE	100
MÉTROPOLE AIX-MARSEILLE-PROVENCE	MÉTROPOLE AIX-MARSEILLE PROVENCE	100
SOC ÉTUDE MAITRISE, OUVRAGE, AMÉNAGEMENT	SOC ÉTUDE, MAITRISE, OUVRAGE, AMÉNAGEMENT	99
GECT EURORÉGION AQUITAINE EUSKADI	GECT EURORÉGION AQUITAINE-EUSKADI	100
RPA DREAL LANGUEDOC-ROUSSILLON-MIDI-PYRENÉES	RPA DREAL LANGUEDOC-ROUSSILLON-MIDI-PYRÉNÉES	99
GIE LOGEMENT FRANÇAIS EN QUALITÉ DE COORDONNATEUR D'UN GROUPEMENT DE COMMANDES COMPOSÉ DE LOGEMENT FRANÇAIS ET DE SES FILIALES: LOGEMENT FRANCILIEN, COOPÉRATION ET FAMILLE, SOLLAR, LOGIS FAMILIAL, LOGIS FAMILIAL VAROIS ET LOGIS MÉDITERRANÉE	GIE LOGEMENT FRANÇAIS EN QUALITÉ DE COORDONNATEUR D'UN GROUPEMENT DE COMMANDES COMPOSÉ DE LOGEMENT FRANÇAIS ET DE SES FILIALES: LOGEMENT FRANCILIEN, COOPÉRATION & FAMILLE, SOLLAR, LOGIS FAMILIAL, LOGIS FAMILIAL VAROIS ET LOGIS MÉDITERRANÉE	99
COMMUNAUTÉ DE COMMUNES DU PAYS CHARITOIS	COMMUNAUTÉ DE COMMUNES PAYS CHARITOIS	96
LYCÉE EDMOND PERRIER	LYCÉE ÉDMOND PERRIER	97
EDF SA DIRECTION DES ACHATS GROUPE	EDF SA — DIRECTION DES ACHATS GROUPE	97
VENDEE LOGEMENT ESH	VENDÉE LOGEMENT ESH	97
CHRU DE BESANON	CHRU DE BESANÇON	100
CEA SACLAY	CEA/SACLAY	100
UNIVERSITÉ PARIS-SORBONNE	UNIVERSITÉ PARIS SORBONNE	100
COLLECTIVITÉ TERRITORIALE MARTINIQUE	COLLECTIVITE TERRITORIALE MARTINIQUE	99
AGENCE DE L'EAU ARTOIS-PICARDIE	AGENCE DE L'EAU ARTOIS — PICARDIE	97
RTE RÉSEAU DE TRANSPORT D'ÉLECTRICITÉ	RTE RÉSEAU DE TRANSPORT D'ELECTRICITÉ	99
COMMUNAUTÉ DE COMMUNES CALVI — BALAGNE	COMMUNAUTÉ DE COMMUNES CALVI-BALAGNE	97
RPA DREAL LANGUEDOC-ROUSSILLON — MIDI-PYRÉNÉES	RPA DREAL LANGUEDOC-ROUSSILLON-MIDI-PYRÉNÉES	98
NIEVRE HABITAT	NIÈVRE HABITAT	96
ANDRA (AGENCE NATIONALE POUR LA GESTION DES DÉCHETS RADIOACTIFS)	ANDRA — AGENCE NATIONALE POUR LA GESTION DES DÉCHETS RADIOACTIFS	99
OFFICE NATIONAL DES FORÊTS	OFFICE NATIONAL DES FORETS	98
MINISTÈRE ÉCONOMIE, INDUSTRIE, EMPLOI	MINISTÈRE ÉCONOMIE INDUSTRIE EMPLOI	97
PARIS, TERRES D'ENVOL	PARIS TERRES D'ENVOL	98
SOCIÉTÉ AÉROPORT MARSEILLE PROVENCE	SOCIÉTÉ AEROPORT MARSEILLE PROVENCE	98
EDF — DIRECTION DES ACHATS — AGENCE RÉGIONALE ACHATS PRODUCTION NORD-OUEST (ARAP NO)	EDF — DIRECTION DES ACHATS — AGENCE RÉGIONALE ACHATS PRODUCTION NORD-OUEST — (ARAP NO)	99
CHD DE LA CANDÉLIE	CHD DE LA CANDELIE	97
VILLE EUROMÉTROPOLE DE STRASBOURG	VILLE, EUROMÉTROPOLE DE STRASBOURG	98
COMMUNAUTÉ COMMUNES DU PAYS DE FAYENCE	COMMUNAUTÉ DE COMMUNES DU PAYS DE FAYENCE	96
COMMUNAUTÉ D'AGGLOMÉRATION DE SAINT OMER	COMMUNAUTÉ D'AGGLOMÉRATION DE SAINT-OMER	100
COMMUNAUTÉ DE COMMUNES COEUR DE LOZÈRE	COMMUNAUTÉ DE COMMUNES CŒUR DE LOZÈRE	96
SYNDICAT MIXTE NORD DAUPHINE	SYNDICAT MIXTE NORD DAUPHINÉ	98
CENTRE HOSPITALIER DES PYRÉNÉES	CENTRE HOSPITALIER DES PYRNES	100
UGECAM RHÔNE-ALPES	UGECAM RHÔNE ALPES	100
COLLECTIVITÉ DE SAINT-MARTIN	COLLECTIVITÉ DE SAINT MARTIN	100
ASSISTANCE PUBLIQUE HOPITAUX DE PARIS	ASSISTANCE PUBLIQUE HÔPITAUX DE PARIS	99
IMMOBILIÈRE ATLANTIC AMENAGEMENT	IMMOBILIÈRE ATLANTIC AMÉNAGEMENT	98
CPAM DU VAL-DE-MARNE	CPAM DU VAL DE MARNE	100
COMMUNAUTÉ D'AGGLOMÉRATION DU BASSIN DE THAU	COMMUNAUTTÉ D'AGGLOMÉRATION DU BASSIN DE THAU	99
GIP GENOPOLE	GIP GÉNOPOLE	96
UGECAM NORD PAS-DE-CALAIS-PICARDIE	UGECAM NORD-PAS-DE-CALAIS — PICARDIE	97
CA CHALON VAL DE BOURGOGNE	CA CHALON-VAL DE BOURGOGNE	100
COMMUNE DE PLAISANCE DU TOUCH	COMMUNE DE PLAISANCE-DU-TOUCH	100
COMMUNAUTÉ D'AGGLOMÉRATION ÉVRY CENTRE ESSONNE	COMMUNAUTÉ D’AGGLOMÉRATION ÉVRY CENTRE ESSONNE	100
COLLECTIVITÉ DE SAINT MARTIN	COLLECTIVITÉ DE SAINT-MARTIN	100
LA POSTE – BRANCHE SERVICES-COURRIER-COLIS	LA POSTE — BRANCHE SERVICES-COURRIER-COLIS	100
GECT — EURORÉGION AQUITAINE-EUSKADI	GECT EURORÉGION AQUITAINE EUSKADI	97
ÉLECTRICITE DE FRANCE	ÉLECTRICITÉ DE FRANCE	97
INSTITUT GÉOGRAPHIQUE NATIONAL	INSTITUT GEOGRAPHIQUE NATIONAL	98
COMMUNAUTÉ D'AGGLOMÉRATION DE LA PORTE DU HAINAUT	COMMUNAUTÉ D'AGGLOMÉRATION LA PORTE DU HAINAUT	97
COMMUNAUTÉ D’AGGLOMÉRATION CREILLOISE	COMMUNAUTÉ DE L'AGGLOMÉRATION CREILLOISE	96
CHI VILLENEUVE-SAINT GEORGES	CHI VILLENEUVE-SAINT-GEORGES	100
COMMISSARIAT À L'ÉNERGIE ATOMIQUE ET AUX ÉNERGIES ALTERNATIVES DE FONTENAY-AUX-ROSES	COMMISSARIAT À L'ÉNERGIE ATOMIQUE ET AUX ÉNERGIES ALTERNATIVES (CEA) — FONTENAY-AUX-ROSES	96
CHD LA ROCHE-SUR-YON - LUÇON - MONTAIGU	CHD LA ROCHE-SUR-YON — LUÇON — MONTAIGU	100
VILLE DE PETIT-COURONNE	VILLE DE PETIT COURONNE	100
MINISTÈRE CHARGÉ DES TRANSPORTS-DGAC	MINISTÈRE CHARGÉ DES TRANSPORTS — DGAC	97
CNRS DÉLÉGATION ALPES	CNRS DÉLEGATION ALPES	97
ÉCOLE NATIONALE SUPÉRIEURE DE CHIMIE DE MONTPELLIER	ÉCOLE NATIONALE SUPÉRIEURE DE CHIMIE MONTPELLIER	97
GIE GROUPE SNI SYSTEMES D'INFORMATION	GIE GROUPE SNI SYSTÈMES D'INFORMATION	99
EDF SA — DIRECTION DES ACHATS GROUPE — DATP — ANAPRI	EDF SA — DIRECTION DES ACHATS GROUPE — DAPI — ANAP	96
COMMUNE DE LA PLAGNE-TARENTAISE	COMMUNE DE LA PLAGNE TARENTAISE	100
DÉPARTEMENT DE LA HAUTE SAÔNE	DÉPARTEMENT DE LA HAUTE-SAÔNE	100
GIE GROUPE SNI TERRITOIRE MIDI-PYRÉNÉES ET LANGUEDOC-ROUSSILLON AU NOM ET POUR LE COMPTE DU NOUVEAU LOGIS MÉRIDIONAL	GIE GROUPE SNI TERRITOIRE MIDI-PYRÉNÉES ET LANGUEDOC-ROUSSILLON AU NOM ET POUR LE COMPTE DU NOUVEAU LOGIS MERIDIONAL	100
ERDF ÉLECTRICITÉ RÉSEAU DISTRIBUTION FRANCE	ERDF, ÉLECTRICITÉ RÉSEAU DISTRIBUTION FRANCE	99
IFP ÉNERGIES NOUVELLES	IFP ENERGIES NOUVELLES	98
SA HLM — PICARDIE HABITAT	SA HLM PICARDIE HABITAT	96
CDC DE LA HAUTE SAINTONGE	CDC DE LA HAUTE-SAINTONGE	100
CCAS — MAISON DE RETRAITE	CCAS-MAISON DE RETRAITE	96
SA HLM LE FOYER RÉMOIS	SA HLM LE FOYER REMOIS	98
INRA ANGERS-NANTES	INRA ANGERS NANTES	100
COMMUNAUTÉ D'AGGLOMÉRATION TOUR(S)PLUS	COMMUNAUTÉ D'AGGLOMÉRATION TOUR(S) PLUS	99
SOC TRANSPORTS EN COMMUN LIMOGES METRO	SOC TRANSPORTS EN COMMUN LIMOGES MÉTRO	99
CENTRE DE GESTION DE LA FPT 77	CENTRE DE GESTION DE LA FPT 76	97
GRAND LYON HABITAT	GRANDLYON HABITAT	97
UNIVERSITÉ TOULOUSE II — JEAN JAURES	UNIVERSITE TOULOUSE II — JEAN JAURES	99
COMMUNAUTÉ AGGLOMERATION BOURGES PLUS	COMMUNAUTÉ AGGLOMÉRATION BOURGES PLUS	99
UNIVERSITÉ PARIS-EST MARNE-LA-VALLÉE	UNIVERSITÉ PARIS EST MARNE-LA-VALLÉE	100
COMMUNAUTÉ DE COMMUNES DU PAYS DE BRAY	COMMUNAUTÉ DE COMMUNES DU PAYS DE NAY	96
CNRS — DÉLÉGATION CENTRE LIMOUSIN POITOU CHARENTES	CNRS — DÉLÉGATION CENTRE LIMOUSIN POITOU-CHARENTES	100
COMMISSARIAT À L'ENERGIE ATOMIQUE ET AUX ÉNERGIES ALTERNATIVES — CEA/SACLAY	COMMISSARIAT À L'ÉNERGIE ATOMIQUE ET AUX ÉNERGIES ALTERNATIVES — CEA/SACLAY	99
MINISTÈRE DE L'INTÉRIEUR	MINISTÈRE DE L'INTERIEUR	98
VILLE DE CHAMBRAY-LÈS-TOURS	VILLE DE CHAMBRAY-LES-TOURS	98
SITCOM CÔTE SUD DES LANDES	SITCOM COTE SUD DES LANDES	98
CCI SEINE ET MARNE	CCI SEINE-ET-MARNE	100
SITCOM COTE SUD DES LANDES	SITCOM CÔTE SUD DES LANDES	98
VILLE D'ANTIBES JUAN-LES-PINS	VILLE D'ANTIBES — JUAN-LES-PINS	97
UNIVERSITÉ TOULOUSE 1, SCIENCES SOCIALES	UNIVERSITÉ TOULOUSE 1, SCIENCES SOCIALE	99
VILLE DE BOULOGNE BILLANCOURT	VILLE DE BOULOGNE-BILLANCOURT	100
MAIRIE DE LA VERRIERE	MAIRIE DE LA VERRIÈRE	98
OFFICE PUBLIC DE L'HABITAT DE L'AGGLOMÉRATION DE LA ROCHELLE	OFFICE PUBLIC DE L’HABITAT DE L'AGGLOMÉRATION DE LA ROCHELLE	100
CG LOIR ET CHER	CG LOIR-ET-CHER	100
COMMUNAUTÉ DE COMMUNES CLUSES-ARVE ET MONTAGNES	COMMUNAUTÉ DE COMMUNES CLUSES ARVE ET MONTAGNES	100
CENTRE HOSPITALIER DE BRIVE	CENTRE HOSPITALIER DE RIVES	96
SIVOM SAINT-GAUDENS MONTREJEAU — ASPET	SIVOM SAINT-GAUDENS MONTREJEAU ASPET	97
SPLA L'OR AMENAGEMENT	SPLA L'OR AMÉNAGEMENT	98
MINDEF/SGA/SPAC/ SOUS-DIRECTION DES ACHATS	MINDEF/SGA/SPAC/SOUS-DIRECTION DES ACHATS	99
VILLE DE CHOISY LE ROI	VILLE DE CHOISY-LE-ROI	100
UNIVERSITE TOULOUSE II — JEAN JAURES	UNIVERSITÉ TOULOUSE II — JEAN JAURES	99
CCI REGION PARIS ÎLE-DE-FRANCE	CCI RÉGION PARIS ÎLE-DE-FRANCE	98
CENTRE INTERNATIONAL ÉTUDES PÉDAGOGIQUES	CTRE INTERNATIONAL ÉTUDES PÉDAGOGIQUES	97
SOCIÉTÉ IMMOBILIÈRE DU DÉPARTEMENT DE LA RÉUNION, SOCIÉTÉ ANONYME D'ECONOMIE MIXTE (SEM) CRÉÉE EN APPLICATION DE L'ARTICLE 2 DE LA LOI DU 30.4.1946 AU CAPITAL DE 125 000 000 EUR — RCS SAINT-DENIS N°74 B 118 — SIRET: 310 863 592 00013	SOCIÉTÉ IMMOBILIÈRE DU DÉPARTEMENT DE LA RÉUNION SOCIÉTÉ ANONYME D'ÉCONOMIE MIXTE (SEM) CRÉÉE EN APPLICATION DE L'ARTICLE 2 DE LA LOI DU 30.4.1946 AU CAPITAL DE 125 000 000 EUR — RCS SAINT DENIS N° 74 B 118 — SIRET: 310 863 592 00013	100
SOCIÉTÉ D'ÉQUIPEMENT DU RHÔNE ET DE LYON	SOCIÉTÉ D'EQUIPEMENT DU RHÔNE ET DE LYON	99
VILLE DE VAL D'ISÈRE	VILLE DE VAL-D'ISÈRE	100
AB HABITAT — SCIC D'HLM D'ARGENTEUIL-BEZONS — 807 567 136 RCS PONTOISE — SIRET 807 567 136 000 13 — NAF 6820 A	AB HABITAT- SCIC D'HLM D'ARGENTEUIL-BEZONS — 807 567 136 RCS PONTOISE — SIRET 807 567 136 000 13- NAF 6820 A	99
ENEDIS QUI MENDATE EDF SA POUR MENER LA PROCÉDURE D'ACHAT	ENEDIS QUI MANDATE EDF SA POUR MENER LA PROCÉDURE D'ACHAT	98
ANDRA — AGENCE NATIONALE POUR LA GESTION DES DÉCHETS RADIOACTIFS	ANDRA (AGENCE NATIONALE POUR LA GESTION DES DÉCHETS RADIOACTIFS)	99
COMMUNAUTÉ D'AGGLOMÉRATION DE PAU-PYRÉNÉES	COMMUNAUTÉ D'AGGLOMÉRATION DE PAU PYRÉNÉES	100
VALOPHIS HABITAT — OPH DU VAL-DE-MARNE	VALOPHIS HABITAT — OPH DU VAL DE MARNE	100
COMMUNAUTÉ URBAINE LE CREUSOT-MONTCEAU	COMMUNAUTÉ URBAINE LE CREUSOT MONTCEAU	100
COMMUNAUTÉ D'AGGLOMÉRATION DE REIMS	COMMUNAUTÉ AGGLOMÉRATION DE REIMS	97
COMMUNE DE MONTS	COMMUNE DE MONT	97
MÉTROPOLE AIX-MARSEILLE-PROVENCE CT 6	MÉTROPOLE AIX-MARSEILLE-PROVENCE CT6	99
CC AVRANCHES-MONT SAINT MICHEL	CC AVRANCHES-MONT-SAINT-MICHEL	100
COMMUNAUTÉ DE COMMUNES OSARTIS MARQUION	COMMUNAUTÉ DE COMMUNES OSARTIS-MARQUION	100
SOCIÉTÉ D'ÉTUDE, DE MAITRISE D'OUVRAGE ET D'AMÉNAGEMENT	SOCIÉTÉ D'ÉTUDE DE MAÎTRISE D'OUVRAGE ET D'AMÉNAGEMENT	98
LOIRE ATLANTIQUE DÉVELOPPEMENT-SELA	LOIRE ATLANTIQUE DÉVELOPPEMENT, SELA	99
CEA CENTRE DE CADARACHE	CEA, CENTRE DE CADARACHE	98
GHR MULHOUSE SUD ALSACE	GHR MULHOUSE SUD-ALSACE	100
SNCF RÉSEAU INGÉNIERIE & PROJETS AGENCE RHÔNE-ALPES AUVERGNE, REPRÉSENTÉE PAR SETEC ORGANISATION, EN SA QUALITÉ DE MANDATAIRE DE MAÎTRISE D'OUVRAGE	SNCF RÉSEAU INGÉNIERIE ET PROJETS — AGENCE RHÔNE-ALPES AUVERGNE, REPRÉSENTÉE PAR SETEC ORGANISATION, EN SA QUALITÉ DE MANDATAIRE DE MAÎTRISE D'OUVRAGE	98
COMMUNAUTÉ D'AGGLOMÉRATION GRAND SÉNONAIS	COMMUNAUTÉ D'AGGLOMÉRATION GD SÉNONAIS	96
REIMS HABITAT CHAMPAGNE ARDENNE	REIMS-HABITAT CHAMPAGNE-ARDENNE	100
INSTITUT PAOLI CALMETTES	INSTITUT PAOLI-CALMETTES	100
CEA, CENTRE DE CADARACHE	CEA CENTRE DE CADARACHE	98
[LA POSTE] DIRECTION DES ACHATS BRANCHE SERVICES COURRIER COLIS	[LA POSTE] DIRECTION DES ACHATS BRANCHE SERVICES-COURRIER-COLIS	100
COMMUNAUTÉ D’AGGLOMÉRATION DU PAYS DE FLERS	COMMUNAUTÉ D'AGGLOMÉRATION DU PAYS DE FLERS	100
AGENCE DE L'EAU ADOUR GARONNE	AGENCE DE L'EAU ADOUR-GARONNE	100
FDE 80 FÉDÉRATION DÉPARTEMENTALE D'ÉNERGIE DE LA SOMME	FDE 80, FÉDÉRATION DÉPARTEMENTALE D'ÉNERGIE DE LA SOMME	99
UNIVERSITE ÉVRY VAL D'ESSONNE	UNIVERSITÉ ÉVRY VAL D'ESSONNE	98
RÉGION LANGUEDOC-ROUSSILLON-MIDI-PYRÉNÉES	RÉGION LANGUEDOC-ROUSSILLON MIDI-PYRÉNÉES	100
DÉPARTEMENT DU BAS-RHIN	DÉPARTEMENT DU BAS RHIN	100
EDF SA — DIRECTION DES ACHATS — AGENCE ACHATS THERMIQUE	EDF SA — DIRECTION DES ACHATS — AGENCE ACHATS THERMIQUES	99
JOINVILLE-LE-PONT HABITAT — OPH	JOINVILLE-LE-PONT HABITAT - OPH	100
CENTRE HOSPITALIER CENTRE BRETAGNE	CENTRE HOSPITALIER DU CENTRE-BRETAGNE	96
ENÉDIS (ANCIENNEMENT ERDF)	ENEDIS (ANCIENNEMENT ERDF)	98
FONDATION LÉOPOLD BELLAN	FONDATION LEOPOLD BELLAN	98
MUSÉE NATIONAL PICASSO — PARIS	MUSÉE NATIONAL PICASSO-PARIS	96
CONSEIL RÉGIONAL ÎLE-DE-FRANCE	CONSEIL RÉGIONAL D'ÎLE-DE-FRANCE	97
SMICVAL DU LIBOURNAIS HAUTE-GIRONDE	SMICVAL DU LIBOURNAIS HAUTE GIRONDE	100
IEDOM — INSTITUT D'ÉMISSION DES DÉPARTEMENTS D'OUTRE-MER	IEDOM INSTITUT D'ÉMISSION DES DÉPARTEMENTS D'OUTRE-MER	98
CRMA NORD — PAS-DE-CALAIS — PICARDIE	CRMA NORD-PAS-DE-CALAIS — PICARDIE	97
MUSÉE NATIONAL PICASSO-PARIS	MUSÉE NATIONAL PICASSO PARIS	100
DIRECTION DÉPARTEMENTALE FIN. PUB. 93	DIRECTION DÉPARTEMENTALE FIN PUB 93	97
EDF SA — DIRECTION DES ACHATS — AAI CIDEN SEPTEN	EDF SA — DIRECTION DES ACHATS-AAI CIDEN SEPTEN	98
GHR MULHOUSE SUD-ALSACE	GHR MULHOUSE SUD ALSACE	100
COMMUNAUTE AGGLOMÉRATION BOURGES PLUS	COMMUNAUTÉ AGGLOMÉRATION BOURGES PLUS	99
GCS INTER-HOSPITALIER DES ARDENNES	GCS INTER HOSPITALIER DES ARDENNES	100
SOCIÉTÉ DES AUTOROUTES PARIS-RHIN-RHÔNE	SOCIÉTÉ DES AUTOROUTES PARIS RHIN RHÔNE	100
TRAMCITES-GPT EGIS RAIL/NORMANDIE-AMÉN	TRAMCITES-GPT EGIS RAIL / NORMANDIE-AMÉN	97
OFFICE NATIONAL DES FORETS	OFFICE NATIONAL DES FORÊTS	98
CENTRE HOSPITALIER DE LA HAUTE GIRONDE	CENTRE HOSPITALIER DE LA HAUTE-GIRONDE	100
CEA (COMMISSARIAT À L'ÉNERGIE ATOMIQUE ET AUX ÉNERGIES ALTERNATIVES)	CEA, COMMISSARIAT À L'ÉNÉRGIE ATOMIQUE ET AUX ÉNERGIES ALTERNATIVES	99
LA POSTE — BRANCHE SERVICES-COURRIER-COLIS	LA POSTE – BRANCHE SERVICES-COURRIER-COLIS	100
AB HABITAT- SCIC D'HLM D'ARGENTEUIL-BEZONS — 807 567 136 RCS PONTOISE — SIRET 807 567 136 000 13- NAF 6820 A	AB HABITAT — SCIC D'HLM D'ARGENTEUIL-BEZONS — 807 567 136 RCS PONTOISE — SIRET 807 567 136 000 13 — NAF 6820 A	99
COMMUNAUTÉ DE COMMUNES DU PAYS D'EVIAN	COMMUNAUTÉ DE COMMUNES DU PAYS D'ÉVIAN	99
GECT EUROREGION AQUITAINE EUSKADI	GECT EURORÉGION AQUITAINE EUSKADI	98
EDF SA — DIRECTION DES ACHATS GROUPE — DAPI — ANAP	EDF SA — DIRECTION DES ACHATS GROUPE — DATP — ANAPRI	96
UGECAM NORD EST	UGECAM NORD-EST	100
COMMUNAUTÉ DE COMMUES DU CENTRE LITTORAL	COMMUNAUTÉ DE COMMUNES DU CENTRE LITTORAL	99
CHAMBRE DE MÉTIERS ET DE L'ARTISANAT	CHAMBRE DE METIERS ET DE L'ARTISANAT	99
DÉPARTEMENT DE LA CORSE-DU-SUD	DÉPARTEMENT DE LA CORSE DU SUD	100
GIP GÉNOPOLE	GIP GENOPOLE	96
MEURTHE ET MOSELLE HABITAT	MEURTHE-ET-MOSELLE HABITAT	100
CA COMMUNAUTÉ PARIS SACLAY	CA COMMUNAUTÉ PARIS-SACLAY	100
LA CITÉ LE CENTRE DES CONGRÈS DE NANTES	LA CITÉ, LE CENTRE DES CONGRÈS DE NANTES	99
MÉTROPOLE AIX-MARSEILLE PROVENCE	MÉTROPOLE AIX-MARSEILLE-PROVENCE	100
PÔLE SANTÉ SARTHE-ET-LOIRE	PÔLE SANTÉ SARTHE ET LOIRE	100
GCS- BLANCHISSERIE DE L'EST FRANCILIEN	GCS — BLANCHISSERIE DE L'EST FRANCILIEN	99
SOCIÉTÉ AEROPORT MARSEILLE PROVENCE	SOCIÉTÉ AÉROPORT MARSEILLE PROVENCE	98
CC DE LA BRIE CHAMPENOISE	CC DE LA BRIE-CHAMPENOISE	100
CHR METZ THIONVILLE	CHR METZ-THIONVILLE	100
SA AÉROPORT MONTPELLIER-MÉDITERRANÉE	SA AÉROPORT MONTPELLIER MÉDITERRANÉE	100
ERDF, ELECTRICITÉ RÉSEAU DISTRIBUTION FRANCE	ERDF, ÉLECTRICITÉ RÉSEAU DISTRIBUTION FRANCE	99
CONSEIL GÉNÉRAL DES HAUTS DE SEINE	CONSEIL GÉNÉRAL DES HAUTS-DE-SEINE	100
VENDÉE LOGEMENT ESH	VENDEE LOGEMENT ESH	97
SAEML SCIENTIPOLE AMÉNAGEMENT	SAEML SCIENTIPÔLE AMÉNAGEMENT	98
CONSEIL D'ÉTAT	CONSEIL D'ETAT	96
LYCÉE HENRI POINCARÉ	LYCÉE HENRI POINCARE	97
COMMUNAUTÉ DE COMMUNES DU PETIT-CAUX	COMMUNAUTÉ DE COMMUNES DU PETIT CAUX	100
UNIVERSITÉ TOULOUSE 1, SCIENCES SOCIALE	UNIVERSITÉ TOULOUSE 1 SCIENCES SOCIALE	99
GRANDANGOULÊME AGGLOMÉRATION	GRAND ANGOULÊME AGGLOMÉRATION	98
LA POSTE DIRECTION GÉNÉRALE DU RÉSEAU	LA POSTE, DIRECTION GÉNÉRALE DU RÉSEAU	99
DOMANYS,	DOMANYS	100
VAL-DE-SEINE AMÉNAGEMENT	VAL DE SEINE AMÉNAGEMENT	100
COMMUNAUTÉ DE COMMUNES ARDENNE RIVES DE MEUSE	COMMUNAUTÉ DE COMMUNES ARDENNES RIVES DE MEUSE	99
CENTRE ÉTUDES EXPERT SUR RISQUES ENVIR M	CENTRE ÉTUDES EXPERT SUR RISQUES ENVIR. M.	99
VILLE DE CHALETTE-SUR-LOING	VILLE DE CHÂLETTE-SUR-LOING	98
CHU DE POINTE À PITRE	CHU DE POINTE-À-PITRE	100
GRPT SERVICES EPLE ESSONNE L.P. PERRIN	GRPT SERVICES EPLE ESSONNE L. P. PERRIN	99
COMMUNAUTÉ DE COMMUNES PAYS CHARITOIS	COMMUNAUTÉ DE COMMUNES DU PAYS CHARITOIS	96
DOMANYS	DOMANYS,	100
COMMISSARIAT À L'ÉNERGIE ATOMIQUE ET AUX ÉNERGIES ALTERNATIVES (CEA) — FONTENAY-AUX-ROSES	COMMISSARIAT A L'ÉNERGIE ATOMIQUE ET AUX ÉNERGIES ALTERNATIVES (CEA) — FONTENAY-AUX-ROSES	99
CENTRE HOSPITALIER DES PYRNES	CENTRE HOSPITALIER DES PYRÉNÉES	100
GECT EURORÉGION AQUITAINE-EUSKADI	GECT EURORÉGION AQUITAINE EUSKADI	100
SA D'HLM PHOCÉENNE D'HABITATIONS	SA D'HLM PHOCEENNE D'HABITATIONS	98
COMMISSARIAT À L'ÉNERGIE ATOMIQUE ET AUX ÉNERGIES ALTERNATIVES	COMMISSARIAT A L'ÉNERGIE ATOMIQUE ET AUX ÉNERGIES ALTERNATIVES	99
CAISSE DES ÉCOLES DU 13ÈME ARRONDISSEMENT	CAISSE DES ÉCOLES DU 15ÈME ARRONDISSEMENT	97
NEOLIA LORRAINE	NÉOLIA LORRAINE	97
GEIE — TUNNEL DU MONT-BLANC	GEIE TUNNEL DU MONT-BLANC	96
AGENCE DE MUTUALISATION DES UNIVERSITÉS	AGENCE DE MUTUALISATION DES UNIVERSITÉ	99
CO-COURTAGE NUCLÉAIRE	CO-COURTAGE NUCLEAIRE	98
LE GROUPEMENT DE COMMANDES, PÔLE IMMOBILIER	LE GROUPEMENT DE COMMANDES «PÔLE IMMOBILIER»	99
SAS LERICHEMONT	SAS LE RICHEMONT	97
CNRS — DÉLEGATION CÔTE D'AZUR	CNRS — DÉLÉGATION CÔTE D'AZUR	98
H-U LA PITIÉ-SALPÊTRIÈRE CHARLES FOIX	HU LA PITIE SALPETRIÈRE CHARLES FOIX	96
MINDEF/EMA/DC SCA/PFAF CO RENNES	MINDEF/EMA/DC SCA/PFAF CO — RENNES	97
METROPOLE D'AIX-MARSEILLE-PROVENCE	METROPOLE D'AIX MARSEILLE PROVENCE	100
SORÉGIES SAEML	SOREGIES SAEML	96
MINISTÈRE DE L'ÉDUCATION NATIONALE DE L'ENSEIGNEMENT SUPÉRIEUR ET DE LA RECHERCHE	MINISTÈRE DE L'ÉDUCATION NATIONALE, DE L'ENSEIGNEMENT SUPÉRIEUR ET DE LA RECHERCHE	99
CONS INTERPROFESSIONNEL VINS PROVENCE	CONSEIL INTERPROFESSIONNEL VINS PROVENCE	96
CHI TOULON LA SEYNE-SUR-MER	CHI TOULON-LA SEYNE-SUR-MER	100
CENTRALE SUPELEC	CENTRALESUPELEC	97
CNRS DÉLEGATION ALPES	CNRS DÉLÉGATION ALPES	97
CC DU PAYS-DE-MORTAGNE	CC DU PAYS DE MORTAGNE	100
MINISTÈRE DE L'INTÉRIEUR DSIC/SDAGA/BA	MINISTÈRE DE L'INTERIEUR DSIC/SDAGA/BA	99
MAISONS ET CITÉS SOGINORPA	MAISONS ET CITÉS/SOGINORPA	100
L'HOPITAL NORD FRANCHE-COMTÉ	L'HÔPITAL NORD FRANCHE-COMTÉ	98
FONDATION LEOPOLD BELLAN	FONDATION LÉOPOLD BELLAN	98
VILLE DE CHÂLETTE-SUR-LOING	VILLE DE CHALETTE-SUR-LOING	98
OPAC DE QUIMPER CORNOUAILLE	OPAC DE QUIMPER-CORNOUAILLE	100
COMMUNAUTÉ D'AGGLOMÉRATION DU LAC DU BOURGET	COMMUNAUTÉ D'AGGLOMÈRATION DU LAC DU BOURGET	100
HÔPITAL SAINTE-ANNE	HOPITAL SAINTE-ANNE	97
CH. VERDUN SAINT-MIHIEL	CH VERDUN SAINT-MIHIEL	98
DYNACITÉ OPH DE L'AIN	DYNACITÉ (OPH DE L'AIN)	98
CHAMBRE RÉGIONALE MÉTIERS ARTISANAT B	CHAMBRE RÉGIONALE MÉTIERS ARTISANAT HN	96
PÔLE EMPLOI BOURGOGNE-FRANCHE-COMTE	PÔLE EMPLOI BOURGOGNE-FRANCHE-COMTÉ	99
LA CREOLE-COMPAGNIE RÉUNIONNAISE EAUX	LA CRÉOLE-COMPAGNIE RÉUNIONNAISE EAUX	99
UNIVERSITÉ DE HAUTE ALSACE	UNIVERSITÉ DE HAUTE-ALSACE	100
UNIVERSITÉ DENIS DIDEROT — PARIS 7	UNIVERSITÉ DENIS DIDEROT-PARIS 7	97
HABITAT EURÉLIEN	HABITAT EURELIEN	97
COMMISSARIAT À L'ÉNERGIE ATOMIQUE ET AUX EÉERGIES ALTERNATIVES	COMMISSARIAT À L'ÉNERGIE ATOMIQUE ET AUX ÉNERGIES ALTERNATIVES	98
CENTRE HOSPITALIER DE SAINT-BRIEUC	CENTRE HOSPITALIER DE SAINT BRIEUC	100
CENTRE HOSPITALIER DE SAINT-MARTIN	CENTRE HOSPITALIER DE SAINT MARTIN	100
CONSEIL GÉNÉRAL DU CALVADOS-CG14	CONSEIL GÉNÉRAL DU CALVADOS — CG14	97
DYNACITÉ (OPH DE L'AIN)	DYNACITÉ OPH DE L'AIN	98
SA AÉROPORT DE BORDEAUX-MÉRIGNAC	SA AÉROPORT DE BORDEAUX MÉRIGNAC	100
COMMUNAUTÉ D'AGGLOMÉRATION DE BOURG-EN-BRESSE	COMMUNAUTÉ D'AGGLOMÉRATION BOURG-EN-BRESSE	96
GH LARIBOISIÈRE-FERNAND W.-SAINT-LOUIS	GH LARIBOISIÈRE-FERNAND W-SAINT LOUIS	99
HÔPITAL INTERCOMMUNAL DU HAUT-LIMOUSIN	HÔPITAL INTERCOMMUNAL DU HAUT LIMOUSIN	100
LOIRE ATLANTIQUE DÉVELOPPEMENT, SELA	LOIRE ATLANTIQUE DÉVELOPPEMENT-SELA	99
[LA POSTE] BRANCHE SERVICES-COURRIER-COLIS (BSCC) FILIALE VIAPOST TRANSPORT MANAGEMENT	[LA POSTE] BRANCHE SERVICES COURRIER COLIS (BSCC) FILIALE VIAPOST TRANSPORT MANAGEMENT	100
COMMUNAUTÉ AGGLOMÉRATION BOURGES PLUS	COMMUNAUTÉ AGGLOMERATION BOURGES PLUS	99
RÉGION NORD PAS-DE-CALAIS-PICARDIE	RÉGION NORD-PAS-DE-CALAIS-PICARDIE	100
CONSEIL RÉGIONAL D'ÎLE-DE-FRANCE	CONSEIL RÉGIONAL ÎLE-DE-FRANCE	97
SILA - SYNDICAT MIXTE DU LAC D'ANNECY	SILA — SYNDICAT MIXTE DU LAC D'ANNECY	100
FDE 80, FÉDÉRATION DÉPARTEMENTALE D'ÉNERGIE DE LA SOMME	FDE 80 FÉDÉRATION DÉPARTEMENTALE D'ÉNERGIE DE LA SOMME	99
VILLE DE CALUIRE-ET-CUIRE	VILLE DE CALUIRE ET CUIRE	100
DÉFENSE ÉTAT-MAJOR DES ARMÉES	DÉFENSE ÉTAT MAJOR DES ARMÉES	100
COMMUNAUTÉ AGGLOMÉRATION DE REIMS	COMMUNAUTÉ D'AGGLOMÉRATION DE REIMS	97
CONSEIL GÉNÉRAL DU PUY DE DÔME	CONSEIL GÉNÉRAL DU PUY-DE-DÔME	100
UNIVERSITÉ PARIS EST MARNE-LA-VALLÉE	UNIVERSITÉ PARIS-EST MARNE-LA-VALLÉE	100
DIR CENTRE-EST	DIR CENTRE EST	100
COMMUNAUT DAGGLOMRATION DE SAINTES	COMMUNAUTÉ D'AGGLOMÉRATION DE SAINTES	99
BATIGÈRE ÎLE-DE-FRANCE	BATIGÈRE ILE-DE-FRANCE	98
DÉPARTEMENT DES CÔTES-D'ARMOR	DÉPARTEMENT DES CÔTES D'ARMOR	100
CHU DE POINTE-À-PITRE	CHU DE POINTE À PITRE	100
HÔPITAUX CIVILS DE COLMAR	HOPITAUX CIVILS DE COLMAR	98
COMMUNAUTÉ DE L'AGGLOMÉRATION CREILLOISE	COMMUNAUTÉ D’AGGLOMÉRATION CREILLOISE	96
DÉPARTEMENT DE LA LOZÈRE — CD 48	DÉPARTEMENT DE LA LOZÈRE, CD 48	98
CENTRE HOSPITALIER DE CHÂTEAU-DU-LOIR	CENTRE HOSPITALIER DE CHÂTEAU DU LOIR	100
CH DE CADILLAC SUR GARONNE	CH DE CADILLAC-SUR-GARONNE	100
COMMUNAUTÉ D'AGGLOMÉRATION GD SÉNONAIS	COMMUNAUTÉ D'AGGLOMÉRATION GRAND SÉNONAIS	96
UNIVERSITE TOULOUSE II — JEAN JAURÈS	UNIVERSITE TOULOUSE II — JEAN JAURES	99
REIMS HABITAT CHAMPAGNE-ARDENNE	REIMS-HABITAT CHAMPAGNE-ARDENNE	100
COMMUNAUTÉ D'AGGLOMÉRATION DU SOISSONNAIS	COMMUNAUTÉ D'AGGLOMÉRATRION DU SOISSONNAIS	99
CUS HABITAT, OFFICE PUBLIC DE L'HABITAT DE L'EUROMÉTROPOLE DE STRASBOURG	CUS HABITAT — OFFICE PUBLIC DE L'HABITAT DE L'EUROMÉTROPOLE DE STRASBOURG	99
INST RECHERCHE TECHNOLOGIQUE AERN ESPA	INST. RECHERCHE TECHNOLOGIQUE AERN ESPA	99
UNIVERSITÉ DE BRETAGNE OCCIDENTALE — BREST	UNIVERSITÉ DE BRETAGNE OCCIDENTALE-BREST	98
SYND. DES TRANSPORTS DE L'AGGLO	SYND.DES TRANSPORTS DE L'AGGLO	98
MINISTÈRE ÉCONOMIE INDUSTRIE EMPLOI	MINISTÈRE ÉCONOMIE, INDUSTRIE, EMPLOI	97
CHD LA ROCHE-SUR-YON-LUÇON-MONTAIGU	CHD LA ROCHE-SUR-YON LUÇON-MONTAIGU	100
[LA POSTE] DIRECTION DES ACHATS BRANCHE COURRIER COLIS SERVICES (BSCC)	[LA POSTE] DIRECTION DES ACHATS — BRANCHE COURRIER COLIS SERVICES (BSCC)	99
ÉTABLISSEMENT FRANÇAIS DU SANG, CENTRE ATLANTIQUE	ÉTABLISSEMENT FRANÇAIS DU SANG CENTRE ATLANTIQUE	99
HÔPITAL INTERCOMMUNAL DU HAUT LIMOUSIN	HÔPITAL INTERCOMMUNAL DU HAUT-LIMOUSIN	100
LYCÉE HENRI POINCARE	LYCÉE HENRI POINCARÉ	97
DISP EST STRASBOURG	DISP EST-STRASBOURG	100
MISSION RÉGIONALE ACHATS MIDI-PYRÉNÉES	MISSION RÉGIONALE ACHATS MIDI PYRÉNÉES	100
COMMUNAUTÉ DE COMMUNES DU VAL DE DRÔME	COMMUNAUTÉ DE COMMUNES DU VAL-DE-DRÔME	100
ÉTABLISSEMENT SNI GRAND OUEST	ÉTABLISSEMENT SNI GRAND-OUEST	100
CEA GRENOBLE	CEA/GRENOBLE	100
CC DU PAYS DE MORTAGNE	CC DU PAYS-DE-MORTAGNE	100
MÉTROPOLE DE LYON	METROPOLE DE LYON	97
COMMUNAUTÉ D’AGGLOMÉRATION CHARLEVILLE-MÉZIÈRES / SEDAN	COMMUNAUTÉ D'AGGLOMÉRATION CHARLEVILLE-MÉZIÈRES / SEDAN	100
SETE — LA TOUR EIFFEL	SETE – LA TOUR EIFFEL	100
GRPT SERVICES EPLE ESSONNE L. P. PERRIN	GRPT SERVICES EPLE ESSONNE L.P. PERRIN	99
GRPT. SERVICES EPLE ESSONNE L. P. PERRIN	GRPT SERVICES EPLE ESSONNE L. P. PERRIN	99
GIE ATOUT FRANCE, AGENCE FRANÇAISE DE DÉVELOPPEMENT TOURISTIQUE	GIE ATOUT FRANCE, AGENCE FRANCAISE DE DEVELOPPEMENT TOURISTIQUE	98
C.H. DE VILLEFRANCHE-SUR-SAÔNE	CH DE VILLEFRANCHE-SUR-SAÔNE	96
CONSEIL DÉPARTEMENTAL DES ALPES-DE-HAUTE-PROVENCE	CONSEIL DÉPARTEMENTAL DES ALPES DE HAUTE-PROVENCE	100
COMMUNE DE MAUGES-SUR-LOIRE	COMMUNE DE MAUVES-SUR-LOIRE	96
NOUVEAU LOGIS MÉRIDIONAL	NOUVEAU LOGIS MERIDIONAL	98
CONSEIL DÉPARTEMENTAL DES ALPES DE HAUTE-PROVENCE	CONSEIL DÉPARTEMENTAL DES ALPES-DE-HAUTE-PROVENCE	100
VILLE DE PETIT COURONNE	VILLE DE PETIT-COURONNE	100
GIE LOGEMENT FRANÇAIS EN QUALITÉ DE COORDONNATEUR D'UN GROUPEMENT DE COMMANDES COMPOSÉ DE LOGEMENT FRANÇAIS ET DE SES FILIALES: LOGEMENT FRANCILIEN, COOPÉRATION & FAMILLE, SOLLAR, LOGIS FAMILIAL, LOGIS FAMILIAL VAROIS ET LOGIS MÉDITERRANÉE	GIE LOGEMENT FRANÇAIS EN QUALITÉ DE COORDONNATEUR D'UN GROUPEMENT DE COMMANDES COMPOSÉ DE LOGEMENT FRANÇAIS ET DE SES FILIALES: LOGEMENT FRANCILIEN, COOPÉRATION ET FAMILLE, SOLLAR, LOGIS FAMILIAL, LOGIS FAMILIAL VAROIS ET LOGIS MÉDITERRANÉE	99
RESEAU DES ACHETEURS HOSPITALIERS IDF	RÉSEAU DES ACHETEURS HOSPITALIERS IDF	99
CHRU DE BESANÇON	CHRU DE BESANON	100
VILLE DE MONT-DE-MARSAN	VILLE DE MONT DE MARSAN	100
ENEDIS (ANCIENNEMENT ERDF)	ENÉDIS (ANCIENNEMENT ERDF)	98
LE GROUPEMENT DE COMMANDES «PÔLE IMMOBILIER» REPRÉSENTÉ PAR POSTE IMMO, EN QUALITÉ DE COORDONNATEUR	LE GROUPEMENT DE COMMANDES «PÔLE IMMOBILIER» REPRÉSENTÉ PAR POSTE IMMO EN QUALITÉ DE COORDONNATEUR	98
CENTRE HOSPITALIER BRETAGNE ATLANTIQUE	CENTRE HOSPITALIER BRETAGNE-ATLANTIQUE	100
BÂTIPLAINE — SOCIÉTÉ DE COORDINATION	BÂTIPLAINE SOCIÉTÉ DE COORDINATION	97
UNIVERSITÉ DE BRETAGNE OCCIDENTALE-BREST	UNIVERSITÉ DE BRETAGNE OCCIDENTALE — BREST	98
CONSEIL DÉPARTEMENTAL DES ALPES DE HAUTE PROVENCE	CONSEIL DÉPARTEMENTAL DES ALPES-DE-HAUTE-PROVENCE	100
CENTRE HOSPITALIER DE CHÂTEAU DU LOIR	CENTRE HOSPITALIER DE CHÂTEAU-DU-LOIR	100
RÉGION PROVENCE ALPES CÔTE D'AZUR	RÉGION PROVENCE-ALPES-CÔTE D'AZUR	100
COMMUNAUTÉ D'AGGLOMÉRATION DE LA ROCHELLE	COMMUNAUTÉ D’AGGLOMÉRATION DE LA ROCHELLE	100
BLANGY PONT-L'ÉVÊQUE INTERCOM	BLANGY-PONT L'ÉVÊQUE INTERCOM	100
SOCIÉTÉ DES AUTOROUTES PARIS RHIN RHÔNE	SOCIÉTÉ DES AUTOROUTES PARIS-RHIN-RHÔNE	100
MINISTÈRE CHARGÉ DES TRANSPORTS — DGAC	MINISTÈRE CHARGÉ DES TRANSPORTS-DGAC	97
CENTRALESUPÉLEC	CENTRALESUPELEC	97
COMMUNAUTÉ D'AGGLOMÉRATION BÉZIERS-MÉDITERRANÉE	COMMUNAUTÉ D'AGGLOMÉRATION BÉZIERS MÉDITERRANÉE	100
LYCÉE PROFESSIONNEL ÉMILE ZOLA	LYCÉE PROFESSIONNEL EMILE ZOLA	98
UNIVERSITÉ PARIS 1 — PANTHÉON-SORBONNE	UNIVERSITÉ PARIS 1 — PANTHÉON SORBONNE	100
ENEDIS QUI MANDATE EDF SA POUR MENER LA PROCÉDURE D'ACHAT — DIRECTION DES ACHATS GROUPE	ERDF QUI MANDATE EDF SA POUR MENER LA PROCÉDURE D'ACHAT — DIRECTION DES ACHATS GROUPE	96
CARSAT CENTRE OUEST	CARSAT CENTRE-OUEST	100
IMMOBILIERE 3F	IMMOBILIÈRE 3F	96
COMMISSARIAT A L'ÉNERGIE ATOMIQUE ET AUX ÉNERGIES ALTERNATIVES	COMMISSARIAT À L'ÉNERGIE ATOMIQUE ET AUX ÉNERGIES ALTERNATIVES	99
ARHM — SAINT-JEAN-DE-DIEU	ARHM — SAINT JEAN DE DIEU	100
UGECAM RHÔNE- ALPES	UGECAM RHÔNE-ALPES	97
LA POSTE SACL — DOT ILE-DE-FRANCE	LA POSTE SACL — DOT ÎLE-DE-FRANCE	98
CEA/GRENOBLE	CEA GRENOBLE	100
GROUPEMENT D'INTÉRÊT PUBLIC (GIP) PARIS 2024	GROUPEMENT D'INTÉRÊT PUBLIC (GIP) — PARIS 2024	98
DÉPARTEMENT DE L'AISNE	DEPARTEMENT DE L'AISNE	98
SÉQUANO AMÉNAGEMENT	SÉQUANO  AMÉNAGEMENT	97
SYND MIXTE VALORISATION DÉCHETS CORSE	SYND MIXTE VALORISATION DECHETS CORSE	99
ÉTABLISSEMENT FRANÇAIS DU SANG-PAYS DE LA LOIRE	ÉTABLISSEMENT FRANÇAIS DU SANG — PAYS DE LA LOIRE	98
COMMUNAUTÉ D’AGGLOMÉRATION DU GRAND DOLE	COMMUNAUTÉ D'AGGLOMÉRATION DU GRAND DOLE	100
COMMUNAUTÉ DE COMMUNES NORD DU BASSIN DE THAU	COMMUNAUTÉ DE COMMUNES DU NORD DU BASSIN DE THAU	97
RTE RÉSEAU DE TRANSPORT D'ELECTRICITÉ	RTE RÉSEAU DE TRANSPORT D'ÉLECTRICITÉ	99
MINDEF/SGA/DCSID/ESID TOULON	MINDEF/SGA/DCSID/ESID.TOULON	100
ALSACE-CHAMPAGNE-ARDENNE-LORRAINE	ALSACE CHAMPAGNE-ARDENNE LORRAINE	100
IMMOBILIERE PODELIHA	IMMOBILIÈRE PODELIHA	97
LE GROUPEMENT DE COMMANDES «PÔLE IMMOBILIER»	LE GROUPEMENT DE COMMANDES, PÔLE IMMOBILIER	100
COMMUNAUTÉ DU BOCAGE COUTANCAIS	COMMUNAUTÉ DU BOCAGE COUTANÇAIS	98
MINDEF/SGA/DCSID/ESID.TOULON	MINDEF/SGA/DCSID/ESID TOULON	100
SOCIÉTÉ D'EQUIPEMENT DU RHÔNE ET DE LYON	SOCIÉTÉ D'ÉQUIPEMENT DU RHÔNE ET DE LYON	99
ERDF, ÉLECTRICITÉ RÉSEAU DISTRIBUTION FRANCE	ERDF ÉLECTRICITÉ RÉSEAU DISTRIBUTION FRANCE	99
COMMUNAUTÉ COMMUNES PÉVÈLE CAREMBAULT	COMMUNAUTÉ DE COMMUNES PÉVÈLE CAREMBAULT	96
CONSEIL DÉPARTEMENTAL HAUTE-GARONNE	CONSEIL DÉPARTEMENTAL HAUTE GARONNE	100
EDF SA — DIRECTION DES ACHATS-AAI CIDEN SEPTEN	EDF SA — DIRECTION DES ACHATS — AAI CIDEN SEPTEN	98
LA POSTE, DIRECTION GÉNÉRALE DU RÉSEAU	LA POSTE — DIRECTION GÉNÉRALE DU RÉSEAU	99
SAEML — NANTES-MÉTROPOLE GESTION ÉQUIPEMENTS	SAEML NANTES-MÉTROPOLE GESTION ÉQUIPEMENTS	98
SYND MIXTE VALORISATION DECHETS CORSE	SYND MIXTE VALORISATION DÉCHETS CORSE	99
CC MATHEYSINE PAYS CORPS VALLÉES VALBON	CC MATHEYSINE PAYS CORPS-VALLEES VALBO	97
GROUPE HOSPITALIER SECLIN ET CARVIN	GROUPE HOSPITALIER SECLIN-CARVIN	96
SNI SUD-EST	SNI SUD EST	100
METROPÔLE D'AIX-MARSEILLE-PROVENCE	METROPOLE D'AIX-MARSEILLE-PROVENCE	99
SOC TRANSPORTS EN COMMUN LIMOGES MÉTRO	SOC TRANSPORTS EN COMMUN LIMOGES METRO	99
CU GRAND PARIS SEINE-ET-OISE	CU GRAND PARIS SEINE ET OISE	100
COMMUNAUTÉ AGGLO. ALBIGEOIS	COMMUNAUTÉ AGGLO ALBIGEOIS	98
EPS DE VILLE ÉVRARD	EPS DE VILLE-ÉVRARD	100
VILLE DE SAINT-ANDRÉ (974)	VILLE DE SAINT ANDRÉ (974)	100
GRANDLYON HABITAT	GRAND LYON HABITAT	97
BEARNAISE HABITAT	BÉARNAISE HABITAT	97
ENEDIS (ANCIENNEMENT ERDF ELECTRICITÉ RÉSEAU DISTRIBUTION FRANCE)	ENEDIS (ANCIENNEMENT ERDF ÉLECTRICITÉ RÉSEAU DISTRIBUTION FRANCE)	99
CONSEIL GÉNÉRAL D'INDRE ET LOIRE	CONSEIL GÉNÉRAL D'INDRE-ET-LOIRE	100
OPH EMERAUDE HABITATION	OPH ÉMERAUDE HABITATION	98
COMMUNAUTÉ DE COMMUNES DU PAYS DE NAY	COMMUNAUTÉ DE COMMUNES DU PAYS DE BRAY	96
GEIE TUNNEL DU MONT-BLANC	GEIE TUNNEL DU MONT BLANC	100
ERDF — ÉLECTRICITÉ RÉSEAU DISTRIBUTION FRANCE	ERDF, ÉLECTRICITÉ RÉSEAU DISTRIBUTION FRANCE	99
EDF SA — DIRECTION DES ACHATS GROUPE	EDF SA DIRECTION DES ACHATS GROUPE	97
SYNDICAT ÉMERAUDE	SYNDICAT EMERAUDE	97
UNIVERSITÉ MICHEL-DE-MONTAIGNE-BORDEAU	UNIVERSITÉ MICHEL DE MONTAIGNE BORDEAU	100
DÉPARTEMENT DU JURA	DEPARTEMENT DU JURA	97
ESH UN TOIT POUR TOUS	ESH «UN TOIT POUR TOUS»	100
OPHLM DE DRANCY	OP HLM DE DRANCY	97
MONTPELLIER MÉDITERRANÉE MÉTROPOLE	MONTPELLIER MÉDITERRANNÉE MÉTROPOLE	98
ARTOIS COMM	ARTOIS COMM.	100
MINDEF/SGA/SPAC/S — DIRECTION DES ACHATS	MINDEF/SGA/SPAC/S-DIRECTION DES ACHATS	97
COMMUNAUTÉ D'AGGLOMÉRATION DE SAINTES	COMMUNAUT DAGGLOMRATION DE SAINTES	99
CONSEIL GAL. DES PYRÉNÉES-ATLANTIQUES	CONSEIL GAL DES PYRÉNÉES-ATLANTIQUES	99
TERRITOIRE HABITAT OPH	TERRITOIRE HABITAT (OPH)	98
COMMISSARIAT À L'ÉNERGIE ATOMIQUE ET AUX ÉNERGIES ALTERNATIVES — CEA/DAM/ ÎLE-DE-FRANCE	CEA COMMISSARIAT À L'ÉNERGIE ATOMIQUE ET AUX ÉNERGIES ALTERNATIVES — CEA/DAM ÎLE-DE-FRANCE	97
SOCIÉTÉ IMMOBILIÈRE DU DÉPARTEMENT DE LA RÉUNION SOCIÉTÉ ANONYME D'ÉCONOMIE MIXTE (SEM) CRÉÉE EN APPLICATION DE L'ARTICLE 2 DE LA LOI DU 30.4.1946 AU CAPITAL DE 125 000 000 EUR — RCS ST DENIS N°74 B 118 — SIRET :310 863 592 00013	SOCIÉTÉ IMMOBILIÈRE DU DÉPARTEMENT DE LA RÉUNION SOCIÉTÉ ANONYME D'ECONOMIE MIXTE (SEM) CRÉÉE EN APPLICATION DE L'ARTICLE 2 DE LA LOI DU 30.4.1946 AU CAPITAL DE 125 000 000 EUR — RCS ST DENIS N°74 B 118 — SIRET :310 863 592 00013	100
[LA POSTE] FILIALES BRANCHE SERVICES COURRIER COLIS (BSCC) FILIALE VIAPOST TRANSPORT MANAGEMENT	[LA POSTE] FILIALES BRANCHE SERVICES-COURRIER-COLIS (BSCC), FILIALE VIAPOST TRANSPORT MANAGEMENT	99
SI ÉNERGIES DE MAINE-ET-LOIRE	SI ÉNERGIES DE MAINE ET LOIRE	100
MAIRIE DE BOLLÃ-NE	MAIRIE DE BOLLÈNE	97
SAINTE PÉRINE — ROSSINI — CHARDON LAGACHE	SAINTE-PÉRINE — ROSSINI — CHARDON LAGACHE	100
SOREGIES SAEML	SORÉGIES SAEML	96
SYNDICAT EMERAUDE	SYNDICAT ÉMERAUDE	97
PRÉFECTURE DE POLICE DFCPP BCP	PRÉFECTURE DE POLICE — DFCPP BCP	97
CHAMBRE RÉGIONALE MÉTIERS ARTISANAT HN	CHAMBRE RÉGIONALE MÉTIERS ARTISANAT B	96
COMMUNAUTÉ COMMUNES CŒUR DE TARENT	COMMUNAUTÉ COMMUNES COEUR DE TARENT	96
CONSEIL GÉNÉRAL D'EURE-ET-LOIR	CONSEIL GÉNÉRAL D'EURE ET LOIR	100
COMMUNAUTÉ D’AGGLOMÉRATION VAR ESTÉREL MÉDITERRANÉE	COMMUNAUTÉ D'AGGLOMÉRATION VAR ESTÉREL MÉDITERRANÉE	100
T38 GRENOBLE ALPES METROPOLE	T38 GRENOBLE ALPES MÉTROPOLE	98
SFVP (SCES FUNÉRAIRES, VILLE DE PARIS)	SFVP (SCES FUNÉRAIRES VILLE DE PARIS)	99
COMMUNAUTÉ D'AGGLOMÉRATION ÉPINAL-GOLBEY	COMMUNAUTÉ D'AGGLOMÉRATION D'ÉPINAL-GOLBEY	97
MIN.DÉFENSE-DCSID-SNIA	MIN. DÉFENSE-DCSID-SNIA	98
MÉDUANE HABITAT	MEDUANE HABITAT	97
CU GRAND PARIS SEINE ET OISE	CU GRAND PARIS SEINE-ET-OISE	100
METROPOLE D'AIX MARSEILLE PROVENCE	METROPOLE D'AIX-MARSEILLE-PROVENCE	100
DEPARTEMENT DU JURA	DÉPARTEMENT DU JURA	97
CENTRE HOSPITALIER GUILLAUME-RÉGNIER	CENTRE HOSPITALIER GUILLAUME RÉGNIER	100
COMMUNAUTÉ DE COMMUNES CALVI-BALAGNE	COMMUNAUTÉ DE COMMUNES CALVI — BALAGNE	97
CPAM DU HAUT-RHI	CPAM DU HAUT-RHIN	97
RÉSEAU DES ACHETEURS HOSPITALIERS IDF	RESEAU DES ACHETEURS HOSPITALIERS IDF	99
COMMUNAUTÉ D'AGGLOMÉRATION BOURGES PLUS	COMMUNAUTÉ AGGLOMÉRATION BOURGES PLUS	97
COMMUNAUTÉ D’AGGLOMÉRATION ÉVRY CENTRE ESSONNE	COMMUNAUTÉ D'AGGLOMÉRATION ÉVRY CENTRE ESSONNE	100
MUSEUM NATIONAL D'HISTOIRE NATURELLE	MUSÉUM NATIONAL D'HISTOIRE NATURELLE	99
DÉPARTEMENT DE LA CORSE DU SUD	DÉPARTEMENT DE LA CORSE-DU-SUD	100
CAISSE DES ÉCOLES DU 15ÈME ARRONDISSEMENT	CAISSE DES ÉCOLES DU 13ÈME ARRONDISSEMENT	97
LA CRÉOLE — COMPAGNIE RÉUNIONNAISE EAUX	LA CRÉOLE-COMPAGNIE RÉUNIONNAISE EAUX	97
CENTRE HOSPITALIER GUILLAUME RÉGNIER	CENTRE HOSPITALIER GUILLAUME-RÉGNIER	100
GROUPEMENT D'INTÉRÊT PUBLIC (GIP) — PARIS 2024	GROUPEMENT D'INTÉRÊT PUBLIC (GIP) PARIS 2024	98
UNIVERSITÉ GRENOBLE-ALPES	UNIVERSITÉ GRENOBLE ALPES	100
SILNE	SILÈNE	100
TERRITOIRE HABITAT (OPH)	TERRITOIRE HABITAT OPH	98
ENEDIS QUI MANDATE EDF SA POUR MENER LA PROCÉDURE D'ACHAT	ENEDIS QUI MENDATE EDF SA POUR MENER LA PROCÉDURE D'ACHAT	98
VILLE DE SAINTE SAVINE	VILLE DE SAINTE-SAVINE	100
COLLECTIVITÉ TERRITORIALE DE MARTINIQUE	COLLECTIVITÉ TERRITORIALE MARTINIQUE	96
COMMUNE DE MONTIGNY-LES-CORMEILLES	COMMUNE DE MONTIGNY-LÈS-CORMEILLES	99
COMMUNE DE CHAMONIX-MONT-BLANC	COMMUNE DE CHAMONIX MONT-BLANC	100
EDF PRODUCTION ÉLECTRIQUE INSULAIRE (EDF PEI)	EDF PRODUCTION ÉLECTRIQUE INSULAIRE SAS (EDF PEI)	96
SA D'HLM PHOCEENNE D'HABITATIONS	SA D'HLM PHOCÉENNE D'HABITATIONS	98
SETE – LA TOUR EIFFEL	SETE — LA TOUR EIFFEL	100
COMMUNAUTÉ D'AGGLOMÉRATION LOIRE-FOREZ	COMMUNAUTÉ D'AGGLOMÉRATION LOIRE FOREZ	100
T38 GRENOBLE ALPES MÉTROPOLE	T38 GRENOBLE ALPES METROPOLE	98
GIE ATOUT FRANCE, AGENCE FRANCAISE DE DEVELOPPEMENT TOURISTIQUE	GIE ATOUT FRANCE, AGENCE FRANÇAISE DE DÉVELOPPEMENT TOURISTIQUE	98
COMMUNAUTÉ DU BOCAGE COUTANÇAIS	COMMUNAUTÉ DU BOCAGE COUTANCAIS	98
SOCIÉTÉ D'ÉTUDE DE MAÎTRISE D'OUVRAGE ET D'AMÉNAGEMENT	SOCIÉTÉ D'ÉTUDE, DE MAITRISE D'OUVRAGE ET D'AMÉNAGEMENT	98
CG LOIR-ET-CHER	CG LOIR ET CHER	100
MUSÉE NATIONAL PICASSO PARIS	MUSÉE NATIONAL PICASSO-PARIS	100
VILLE DU PERREUX-SUR-MARNE	VILLE DU PERREUX-SUR MARNE	100
COMMUNAUTE ARTOIS-LYS	COMMUNAUTÉ ARTOIS-LYS	98
VILLE DES TROIS-ILETS	VILLE DES TROIS-ÎLETS	98
ÉTABLISSEMENT FRANÇAIS DU SANG — PAYS DE LA LOIRE	ÉTABLISSEMENT FRANÇAIS DU SANG-PAYS DE LA LOIRE	98
GROUPEMENT DE COMMANDES	GROUPEMENTS DE COMMANDES	98
CHU AMIENS PICARDIE	CHU AMIENS-PICARDIE	100
CENTRE HOSPITALIER A. GUÉRIN	CENTRE HOSPITALIER A.GUÉRIN	98
COMMUNAUTÉ URBAINE LE CREUSOT MONTCEAU	COMMUNAUTÉ URBAINE LE CREUSOT-MONTCEAU	100
QUIMPER COMMUNAUTÉ	QUIMPERLÉ COMMUNAUTÉ	97
ARHM — SAINT JEAN DE DIEU	ARHM — SAINT-JEAN-DE-DIEU	100
CCAS-MAISON DE RETRAITE	CCAS — MAISON DE RETRAITE	96
SÉQUANO  AMÉNAGEMENT	SÉQUANO AMÉNAGEMENT	97
UNIVERSITÉ PARIS-EST-CRÉTEIL	UNIVERSITÉ PARIS-EST CRÉTEIL	100
SETE- LA TOUR EIFFEL	SETE — LA TOUR EIFFEL	98
MINISTÈRE ÉCONOMIE FINANCES INDUSTRIE	MINISTÈRE ÉCONOMIE, FINANCES, INDUSTRIE	97
CARSAT LANGUEDOC-ROUSSILLON	CARSAT LANGUEDOC ROUSSILLON	100
COMMUNAUTÉ D'AGGLOMÉRATION CHARLEVILLE-MÉZIÈRES / SEDAN	COMMUNAUTÉ D’AGGLOMÉRATION CHARLEVILLE-MÉZIÈRES / SEDAN	100
VILLE DE BOULOGNE-BILLANCOURT	VILLE DE BOULOGNE BILLANCOURT	100
SYND.DES TRANSPORTS DE L'AGGLO	SYND. DES TRANSPORTS DE L'AGGLO	98
LOGEAL IMMOBILIÈRE	LOGÉAL IMMOBILIÈRE	97
CENTRE HOSPITALIER DE BRETAGNE-SUD	CENTRE HOSPITALIER DE BRETAGNE SUD	100
DÉFENSE ÉTAT MAJOR DES ARMÉES	DÉFENSE ÉTAT-MAJOR DES ARMÉES	100
COMMUNE DE MONTIGNY-LÈS-CORMEILLES	COMMUNE DE MONTIGNY-LES-CORMEILLES	99
VILLE DE CRÉTEIL	VILLE DE CREIL	97
GCS INTER HOSPITALIER DES ARDENNES	GCS INTER-HOSPITALIER DES ARDENNES	100
CC AVRANCHES-MONT-SAINT-MICHEL	CC AVRANCHES-MONT SAINT MICHEL	100
GEIE TUNNEL DU MONT BLANC	GEIE TUNNEL DU MONT-BLANC	100
CENTRE HOSPITALIER DE SENS	CENTRE HOSPITALIER DE LENS	96
COMMUNUATÉ D'AGGLOMÉRATION LIMOGES MÉTROPOLE	COMMUNAUTÉ D'AGGLOMÉRATION LIMOGES MÉTROPOLE	98
RÉGION LANGUEDOC-ROUSSILLON MIDI-PYRÉNÉES	RÉGION LANGUEDOC-ROUSSILLON-MIDI-PYRÉNÉES	100
VILLE DE CHAMBRAY-LES-TOURS	VILLE DE CHAMBRAY-LÈS-TOURS	98
CARSAT LANGUEDOC ROUSSILLON	CARSAT LANGUEDOC-ROUSSILLON	100
VILLE DE SAINT-BENOÎT	VILLE DE SAINT-BENOIT	98
UNIVERSITÉ FRANÇOIS RABELAIS DE TOURS	UNIVERSITÉ FRANÇOIS-RABELAIS DE TOURS	100
DIR-CENTRE EST	DIR CENTRE EST	100
EMMAÜS HABITAT	EMMAUS HABITAT	96
COMMUNE DE PORTET SUR GARONNE	COMMUNE DE PORTET-SUR-GARONNE	100
MÉTROPOLE D'AIX-MARSEILLE PROVENCE	MÉTROPOLE D'AIX-MARSEILLE-PROVENCE	100
CAISSE DES ÉCOLES DU 2ÉME ARRONDISSEMENT	CAISSE DES ÉCOLES DU 13ÈME ARRONDISSEMENT	96
CDG 67 - CENTRE DE GESTION DE LA FONCTION PUBLIQUE	CDG 52 - CENTRE DE GESTION DE LA FONCTION PUBLIQUE	96
PAS DE CALAIS HABITAT	PAS-DE-CALAIS HABITAT	100
ASSISTANCE PUBLIQUE — HÔPITAUX DE PARIS	ASSISTANCE PUBLIQUE - HÔPITAUX DE PARIS	100
LOGIS SOCIAL DU VAL-D'OISE	LOGIS SOCIAL DU VAL D'OISE	100
COMMUNAUTÉ D'AGGLOM/RATION DU PAYS VOIRONNAIS	COMMUNAUTÉ D'AGGLOMÉRATION DU PAYS VOIRONNAIS	99
CENTRE HOSPITALIER DE LA HAUTE-GIRONDE	CENTRE HOSPITALIER DE LA HAUTE GIRONDE	100
COMITÉ RÉGIONAL DU TOURISME DE BOURGOG	COMITÉ RÉGIONAL DU TOURISME DE BOURGOGNE	97
COMMUNAUTÉ D'AGGLOMÉRATION BOURG-EN-BRESSE	COMMUNAUTÉ AGGLOMÉRATION BOURG-EN-BRESSE	97
COMMUNAUTÉ DE COMMUNES DE GRANVILLE, TERRE ET MER	COMMUNAUTÉ DE COMMUNES GRANVILLE, TERRE ET MER	97
SA HLM LE FOYER REMOIS	SA HLM LE FOYER RÉMOIS	98
EDF SA DIRECTION DES ACHATS ARAP GRAND OUEST	EDF SA — DIRECTION DES ACHATS — ARAP GRAND OUEST	96
NOUVEAU LOGIS MERIDIONAL	NOUVEAU LOGIS MÉRIDIONAL	98
MINDEF/EMA/DC SCA/PFAF CO — RENNES	MINDEF/EMA/DC SCA/PFAF CO RENNES	97
OPÉRA TOULON PROVENCE MÉDITERRANÉE	OPERA TOULON PROVENCE MEDITERRANÉE	97
VILLE DE BOURG-SAINT-MAURICE — ARCS	VILLE DE BOURG-SAINT MAURICE-ARCS	97
COMMISSARIAT A L'ÉNERGIE ATOMIQUE ET AUX ÉNERGIES ALTERNATIVES (CEA)	COMMISSARIAT À L'ÉNERGIE ATOMIQUE ET AUX ÉNERGIES ALTERNATIVES (CEA)	99
VILLE DE SAINT ANDRÉ (974)	VILLE DE SAINT-ANDRÉ (974)	100
GRENOBLE ALPES-MÉTROPOLE	GRENOBLE ALPES MÉTROPOLE	100
CPCU COMPAGNIE PARISIENNE DE CHAUFFAGE URBAIN	CPCU — COMPAGNIE PARISIENNE DE CHAUFFAGE URBAIN	98
CENTRE HOSPITALIER BRETAGNE-ATLANTIQUE	CENTRE HOSPITALIER BRETAGNE ATLANTIQUE	100
ORVITIS — SERVICE MARCHÉS	ORVITIS SERVICE MARCHÉS	96
CENTRE HOSPITALIER DE MONTERAN	CENTRE HOSPITALIER DE MONTÉRAN	98
DREAL 5962 SG	DREAL5962 SG	96
COMMUNAUTÉ DE COMMUNES DU PAYS DU MONT-BLANC	COMMUNAUTÉ DE COMMUNES PAYS DU MONT-BLANC	96
SPLA L'OR AMÉNAGEMENT	SPLA L'OR AMENAGEMENT	98
COMMUNAUTÉ AGGLOMÉRATION CHARLEVILLE-MÉZIÈRES/ SEDAN	COMMUNAUTÉ AGGLOMÉRATION CHARLEVILLE-MÉZIÈRES / SEDAN	99
SOCIÉTÉ IMMOBILIÈRE DU DÉPARTEMENT DE LA RÉUNION SOCIÉTÉ ANONYME D'ÉCONOMIE MIXTE (SEM) CRÉÉE EN APPLICATION DE L'ARTICLE 2 DE LA LOI DU 30 AVRIL 1946 AU CAPITAL DE 125 000 000 EUR — RCS ST DENIS N°74 B 118 — SIRET :310 863 592 00013	SOCIÉTÉ IMMOBILIÈRE DU DÉPARTEMENT DE LA RÉUNION SOCIÉTÉ ANONYME D'ÉCONOMIE MIXTE (SEM) CRÉÉE EN APPLICATION DE L'ARTICLE 2 DE LA LOI DU 30.4.1946 AU CAPITAL DE 125 000 000 EUR — RCS ST-DENIS N° 74 B 118 — SIRET: 310 863 592 00013	99
AGGLOMÉRATION MAUBEUGE VAL DE SAMBRE	AGGLOMÉRATION MAUBEUGE-VAL DE SAMBRE	100
CH PAYS AIX — CHI AIX PERTUIS	CH PAYS AIX — CHI AIX-PERTUIS	100
RÉGIE DES TRANSPORTS DE CARBONNE	RGIE DES TRANSPORTS DE CARBONNE	100
BÉARNAISE HABITAT	BEARNAISE HABITAT	97
CCI SEINE-ET-MARNE	CCI SEINE ET MARNE	100
VILLE DES TROIS-ÎLETS	VILLE DES TROIS-ILETS	98
GH DE LA HAUTE SAÔNE	GH DE LA HAUTE-SAÔNE	100
DÉPARTEMENT DE LA HAUTE-SAÔNE	DÉPARTEMENT DE LA HAUTE SAÔNE	100
GIE GROUPE SNI TERRITOIRE MIDI-PYRÉNÉES ET LANGUEDOC-ROUSSILLON AU NOM ET POUR LE COMPTE DU NOUVEAU LOGIS MERIDIONAL	GIE GROUPE SNI TERRITOIRE MIDI-PYRÉNÉES ET LANGUEDOC-ROUSSILLON AU NOM ET POUR LE COMPTE DU NOUVEAU LOGIS MÉRIDIONAL	100
COMMUNAUTÉ AGGLOMÉRATION PRIVAS CENTRE ARDRÈCHE	COMMUNAUTÉ D'AGGLOMÉRATION PRIVAS CENTRE ARDÈCHE	97
MINISTÈRE DE LA JUSTICE ET DES LIBÉRTÉS	MINISTÈRE DE LA JUSTICE ET DES LIBÉRTÉ	99
SEQUANO AMÉNAGEMENT	SÉQUANO AMÉNAGEMENT	97
COMMUNAUTÉ AGGLO ALBIGEOIS	COMMUNAUTÉ AGGLO. ALBIGEOIS	98
COMMUNAUTÉ D'AGGLOMÉRATION DU PAYS VOIRONNAIS	COMMUNAUTÉ D'AGGLOM/RATION DU PAYS VOIRONNAIS	99
ÉLECTRICITÉ DE FRANCE	ÉLECTRICITE DE FRANCE	97
COMMUNAUTÉ DE COMMUNES CLUSES ARVE ET MONTAGNES	COMMUNAUTÉ DE COMMUNES CLUSES-ARVE ET MONTAGNES	100
AB HABITAT — SCIC D'HLM D'ARGENTEUIL-BEZONS — 807 567 136 RCS PONTOISE — SIRET 807 567 136 000 21 — NAF 6820 A	AB HABITAT — SCIC D'HLM D'ARGENTEUIL-BEZONS — 807 567 136 RCS PONTOISE — SIRET 807 567 136 000 13 — NAF 6820 A	99
SIAEA GUADELOUPE	SIAEAG GUADELOUPE	97
UNIVERSITÉ PARIS 1 — PANTHÉON SORBONNE	UNIVERSITÉ PARIS 1 — PANTHÉON-SORBONNE	100
COMMUNAUTÉ DE COMMUNES ARC SUD BRETAGN	COMMUNAUTÉ DE COMMUNES ARC SUD BRETAGNE	99
VALOPHIS HABITAT, OPH VAL-DE-MARNE	VALOPHIS HABITAT — OPH VAL-DE-MARNE	99
CRMA NORD-PAS-DE-CALAIS — PICARDIE	CRMA NORD — PAS-DE-CALAIS — PICARDIE	97
CRMA NORD-PAS-DE-CALAIS-PICARDIE	CRMA NORD-PAS-DE-CALAIS — PICARDIE	97
CEA/SACLAY	CEA SACLAY	100
VILLE DU BLANC-MESNIL	VILLE DU BLANC MESNIL	100
SOC MIXTE AMENAG VILLE LAMENTIN	SOC MIXTE AMÉNAG VILLE LAMENTIN	98
CONSEIL GÉNÉRAL DU CALVADOS — CG14	CONSEIL GÉNÉRAL DU CALVADOS-CG14	97
ERDF QUI MANDATE EDF SA POUR MENER LA PROCÉDURE D'ACHAT — DIRECTION DES ACHATS GROUPE	ENEDIS QUI MANDATE EDF SA POUR MENER LA PROCÉDURE D'ACHAT — DIRECTION DES ACHATS GROUPE	96
COMMUNAUTÉ DE COMMUNES DU CANTON DE PI	COMMUNAUTÉ DE COMMUNES DU CANTON DE RI	97
ÉLÉCTRICITÉ RÉSEAU DISTRIBUTION FRANCE (ERDF)	ÉLECTRICITÉ RÉSEAU DISTRIBUTION FRANCE (ERDF)	99
EDF — DIRECTION DES ACHATS — AGENCE RÉGIONALE ACHATS PRODUCTION NORD-OUEST — (ARAP NO)	EDF — DIRECTION DES ACHATS — AGENCE RÉGIONALE ACHATS PRODUCTION NORD-OUEST (ARAP NO)	99
CDG 52 - CENTRE DE GESTION DE LA FONCTION PUBLIQUE	CDG 67 - CENTRE DE GESTION DE LA FONCTION PUBLIQUE	96
EPT GRAND PARIS-SEINE-OUEST	EPT GRAND PARIS SEINE OUEST	100
MÉTROPOLE AIX MARSEILLE PROVENCE	MÉTROPOLE AIX-MARSEILLE-PROVENCE	100
CONSEIL GAL DES PYRÉNÉES-ATLANTIQUES	CONSEIL GAL. DES PYRÉNÉES-ATLANTIQUES	99
GCS — BLANCHISSERIE DE L'EST FRANCILIEN	GCS- BLANCHISSERIE DE L'EST FRANCILIEN	99
CIF COOPÉRATIVE	CIF COOPERATIVE	97
CAISSE DES ÉCOLES DU 11ÈME ARRONDISSEMENT	CAISSE DES ÉCOLES DU 13ÈME ARRONDISSEMENT	97
VILLE DE CHOISY-LE-ROI	VILLE DE CHOISY LE ROI	100
SEDD MANDATAIRE CRFC	SEDD MANDATAIRE CRBFC	98
COMMUNAUTÉ DES COMMUNES CÔTE DE PENTHIÈVRE	COMMUNAUTÉ DE COMMUNES CÔTE DE PENTHIÈVRE	99
RÉGION ILE-DE-FRANCE	RÉGION ÎLE-DE-FRANCE	97
CENTRE HOSPITALIER DE SAINT BRIEUC	CENTRE HOSPITALIER DE SAINT-BRIEUC	100
MINISTÈRE DE L'ÉDUCATION NATIONALE, DE L'ENSEIGNEMENT SUPÉRIEUR ET DE LA RECHERCHE	MINISTÈRE DE L'ÉDUCATION NATIONALE DE L'ENSEIGNEMENT SUPÉRIEUR ET DE LA RECHERCHE	99
SILA — SYNDICAT MIXTE DU LAC D'ANNECY	SILA - SYNDICAT MIXTE DU LAC D'ANNECY	100
PÔLE EMPLOI BOURGOGNE-FRANCHE-COMTÉ	PÔLE EMPLOI BOURGOGNE-FRANCHE-COMTE	99
BANQUE DE FRANCE — DIRECTION DES ACHATS	BANQUE DE FRANCE - DIRECTION DES ACHATS	100
EPF ILE DE FRANCE	EPF ÎLE-DE-FRANCE	97
EP SÉCURITÉ FERROVIAIRE	EP SECURITÉ FERROVIAIRE	98
COMMUNE DE MONT	COMMUNE DE MONTS	97
METROPOLE D'AIX-MARSEILLE PROVENCE	METROPOLE D'AIX-MARSEILLE-PROVENCE	100
COMMUNAUTÉ D'AGGLOMERATION LA ROCHELLE	COMMUNAUTÉ D'AGGLOMÉRATION LA ROCHELLE	99
LOGEMENT FRANCILIEN REPRÉSENTÉ PAR GIE LOGEMENT FRANÇAIS	LOGEMENT FRANCILIEN REPRÉSENTÉ PAR GIE LOGEMENT FRANCAIS	99
REGION ÎLE-DE-FRANCE	RÉGION ÎLE-DE-FRANCE	97
SYND. MIXTE VALORISATION DÉCHETS CORSE	SYND MIXTE VALORISATION DÉCHETS CORSE	99
DÉPARTEMENT D'ILLE ET VILAINE	DÉPARTEMENT D'ILLE-ET-VILAINE	100
GROUPEMENT DE CDES DES ÉTABLISSEMENTS	GRPEMENT DE CDES DES ÉTABLISSEMENTS	97
TUNNEL EURALPIN LYON-TURIN SAS	TUNNEL EURALPIN LYON TURIN SAS	100
ARCHIPEL HABITAT OPH DE RENNES MÉTROPOLE	ARCHIPEL HABITAT — OPH DE RENNES MÉTROPOLE	98
CONSEIL RÉGIONAL LANGUEDOC ROUSSILLON	CONSEIL RÉGIONAL LANGUEDOC-ROUSSILLON	100
LOCMINE COMMUNAUTÉ	LOCMINÉ COMMUNAUTÉ	97
LOGIS SOCIAL DU VAL D'OISE	LOGIS SOCIAL DU VAL-D'OISE	100
AGGLOMÉRATION MAUBEUGE-VAL DE SAMBRE	AGGLOMÉRATION MAUBEUGE VAL DE SAMBRE	100
COMMISSARIAT À L'ÉNERGIE ATOMIQUE ET AUX ÉNERGIES ALTERNATIVES (CEA)	COMMISSARIAT A L'ÉNERGIE ATOMIQUE ET AUX ÉNERGIES ALTERNATIVES (CEA)	99
GIE SESAM VITALE	GIE SESAM-VITALE	100
EPIC OFFICE DU TOURISME	EPIC — OFFICE DU TOURISME	96
MINISTÈRE DE LA DÉFENSE — BCAC-CG 195/M	MINISTÈRE DE LA DÉFENSE — BCAC-CG195/M	99
UGECAM NORD-EST	UGECAM NORD EST	100
CHI TOULON, LA SEYNE-SUR-MER	CHI TOULON LA SEYNE-SUR-MER	98
IFP ENERGIES NOUVELLES	IFP ÉNERGIES NOUVELLES	98
CCI DE NÎMES-BAGNOLS-UZÈS-LE VIGAN	CCI DE NÎMES BAGNOLS UZÈS LE VIGAN	100
COMMUNAUTÉ DE COMMUNES DE LA SAVE AU TOUCH	COMMUNAUTÉ COMMUNES DE LA SAVE AU TOUCH	96
TARN ET GARONNE HABITAT	TARN-ET-GARONNE HABITAT	100
DÉPARTEMENT DES BOUCHES DU RHÔNE	DÉPARTEMENT DES BOUCHES-DU-RHÔNE	100
AGGLOMÉRATION MAUBEUGE - VAL DE SAMBRE	AGGLOMÉRATION MAUBEUGE VAL DE SAMBRE	97
DÉPARTEMENT DU BAS RHIN	DÉPARTEMENT DU BAS-RHIN	100
LA POSTE BRANCHE SERVICES-COURRIER-COLIS	LA POSTE – BRANCHE SERVICES-COURRIER-COLIS	98
MINDEF/SGA/SPAC/SOUS-DIRECTION DES ACHATS	MINDEF/SGA/SPAC/ SOUS-DIRECTION DES ACHATS	99
CONSEIL D'ETAT	CONSEIL D'ÉTAT	96
CONSEIL RÉGIONAL PROVENCE-ALPES-CÔTE D'AZUR	CONSEIL RÉGIONAL DE PROVENCE-ALPES-CÔTE D'AZUR	96
SAEML NANTES-MÉTROPOLE, GESTION ÉQUIPEMENTS	SAEML NANTES-MÉTROPOLE GESTION ÉQUIPEMENTS	99
CH VERDUN SAINT-MIHIEL	CH. VERDUN SAINT-MIHIEL	98
VILLE DE CORMEILLES-EN-PARISIS	VILLE DE CORMEILLES EN PARISIS	100
RTE — RÉSEAU DE TRANSPORT D'ÉLECTRICITÉ	RTE — RÉSEAU DE TRANSPORT D'ELECTRICITÉ	99
COMMUNAUTÉ DE COMMUNES ARDENNES RIVES DE MEUSE	COMMUNAUTÉ DE COMMUNES ARDENNE RIVES DE MEUSE	99
CIF COOPERATIVE	CIF COOPÉRATIVE	97
EPS DE VILLE-ÉVRARD	EPS DE VILLE ÉVRARD	100
SI ÉNERGIES DE MAINE ET LOIRE	SI ÉNERGIES DE MAINE-ET-LOIRE	100
COMMUNAUTÉ D’AGGLOMÉRATION DE CHÂLONS-EN-CHAMPAGNE	COMMUNAUTÉ D'AGGLOMÉRATION DE CHÂLONS-EN-CHAMPAGNE	100
VILLE DE SAINT GRÉGOIRE	VILLE DE SAINT-GRÉGOIRE	100
CONSEIL GÉNÉRAL DU VAL-D'OISE	CONSEIL GÉNÉRAL DU VAL D'OISE	100
CONSEIL DÉPARTEMENTAL HAUTE GARONNE	CONSEIL DÉPARTEMENTAL HAUTE-GARONNE	100
DÉPARTEMENT DES RECHERCHES ARCHÉOLOGIQUE	DÉPARTEMENT DES RECHERCHES ARCHÉOLOGIQUES	99
CH DE VILLEFRANCHE-SUR-SAÔNE	C.H. DE VILLEFRANCHE-SUR-SAÔNE	96
COMMUNE DE MONT-DE-LANS	COMMUNE DE MONT DE LANS	100
EDF SA — DIRECTION DES ACHATS — AGENCE ACHATS THERMIQUES	EDF SA — DIRECTION DES ACHATS — AGENCE ACHATS THERMIQUE	99
EPS ROGER PRÉVOT	EPS ROGER PREVOT	97
CONSEIL GÉNÉRAL DU VAL D'OISE	CONSEIL GÉNÉRAL DU VAL-D'OISE	100
MEURTHE-ET-MOSELLE HABITAT	MEURTHE ET MOSELLE HABITAT	100
UNIVERSITÉ TOULOUSE II-JEAN JAURÈS	UNIVERSITÉ TOULOUSE II — JEAN JAURÈS	97
UNIVERSITÉ DE BRETAGNE-SUD	UNIVERSITÉ DE BRETAGNE SUD	100
COMMUNAUTÉ DE COMMUNES PAYS DU MONT-BLANC	COMMUNAUTÉ DE COMMUNES DU PAYS DU MONT-BLANC	96
CTÉ D'AGGLO DE PAU PYRÉNÉES	CTÉ D'AGGLO. DE PAU PYRÉNÉES	98
SYNDICAT MIXTE DÉPARTEMENTAL DE LA VOIRIE DES COMMUNES DE LA CHARENTE-MARITIME	SYNDICAT MIXTE DÉPARTEMENTAL DE LA VOIRIE DES COMMUNES DE CHARENTE-MARITIME	98
[LA POSTE] FILIALES BRANCHE SERVICES-COURRIER-COLIS (BSCC), FILIALE VIAPOST TRANSPORT MANAGEMENT	[LA POSTE] FILIALES BRANCHE SERVICES COURRIER COLIS (BSCC) FILIALE VIAPOST TRANSPORT MANAGEMENT	99
CO-COURTAGE NUCLEAIRE	CO-COURTAGE NUCLÉAIRE	98
COMMUNAUTÉ COMMUNES DE LA SAVE AU TOUCH	COMMUNAUTÉ DE COMMUNES DE LA SAVE AU TOUCH	96
GCS TÉLÉSANTÉ BASSE NORMANDIE	GCS TÉLÉSANTÉ BASSE-NORMANDIE	100
IMMOBILIÈRE ATLANTIC AMÉNAGEMENT	IMMOBILIÈRE ATLANTIC AMENAGEMENT	98
SAEML SCIENTIPÔLE AMÉNAGEMENT	SAEML SCIENTIPOLE AMÉNAGEMENT	98
JOINVILLE-LE-PONT HABITAT - OPH	JOINVILLE-LE-PONT HABITAT — OPH	100
GH LARIBOISIÈRE-FERNAND W-SAINT LOUIS	GH LARIBOISIÈRE-FERNAND W.-SAINT-LOUIS	99
GUSTAVE-ROUSSY	GUSTAVE ROUSSY	100
ESCOTA — SOCIÉTÉ DES AUTOROUTES ESTÉREL, CÔTE D'AZUR, PROVENCE, ALPES	ESCOTA — SOCIETÉ DES AUTOROUTES ESTÉREL, CÔTE D'AZUR, PROVENCE, ALPES	99
QUIMPERLÉ COMMUNAUTÉ	QUIMPER COMMUNAUTÉ	97
LA NANTAISE D'HABITATIONS	LA NANTAISE D' HABITATIONS	98
MÉTROPOLE D'AIX-MARSEILLE-PROVENCE	MÉTROPOLE D'AIX-MARSEILLE PROVENCE	100
MIINDEF/SGA/DCSID/ESID BORDEAUX	MINDEF/SGA/DCSID/ESID BORDEAUX	98
EMMAUS HABITAT	EMMAÜS HABITAT	96
COMMUNAUTÉ AGGLOMÉRATION SOPHIA-ANTIPOLIS	COMMUNAUTÉ D'AGGLOMÉRATION SOPHIA ANTIPOLIS	98
IMMOBILIÈRE PODELIHA	IMMOBILIERE PODELIHA	97
CENTRE RÉGIONAL DES OEUVRES UNIVERSITAIRES ET SCOLAIRES	CENTRE RÉGIONAL DES ŒUVRES UNIVERSITAIRES ET SCOLAIRES	97
METROPOLE DE LYON	MÉTROPOLE DE LYON	97
DÉPARTEMENT DE SEINE-MARITIME	DÉPARTEMENT DE SEINE MARITIME	100
MARNE-ET-CHANTEREINE HABITAT	MARNE ET CHANTEREINE HABITAT	100
FONDATION CAISSES D'ÉPARGNE POUR LA SOLIDARITÉ (FCES)	FONDATION CAISSES D'EPARGNE POUR LA SOLIDARITÉ (FCES)	99
COMMUNE DE LA PLAGNE TARENTAISE	COMMUNE DE LA PLAGNE-TARENTAISE	100
COMMUNAUPOLE DE LENS-LIÉVIN	COMMUNAUPÔLE DE LENS-LIÉVIN	98
COMMUNAUTÉ DE CMES DU CENTRE LITTORAL	COMMUNAUTÉ DE COMMUES DU CENTRE LITTORAL	96
SDEA ALSACE MOSELLE	SDEA ALSACE-MOSELLE	100
ASSISTANCE PUBLIQUE-HÔPITAUX DE PARIS	ASSISTANCE PUBLIQUE HÔPITAUX DE PARIS	100
COMMUNAUTÉ COMMUNES PAYS D'HÉRICOURT	COMMUNAUTÉ DE COMMUNES PAYS D'HÉRICOURT	96
ADEME — AGENCE DE L'ENVIRONNEMENT ET DE LA MAÎTRISE DE L'ENERGIE	ADEME — AGENCE DE L'ENVIRONNEMENT ET DE LA MAÎTRISE DE L'ÉNERGIE	99
EDF — DIRECTION DES ACHATS GROUPE	EDF SA DIRECTION DES ACHATS GROUPE	96
VILLE DU BLANC MESNIL	VILLE DU BLANC-MESNIL	100
ÉTABLISSEMENT MÉDICO-SOCIAL	ÉTABLISSEMENT MÉDICO SOCIAL	100
MINDEF/SGA/DCSID/ESID BORDEAUX	MIINDEF/SGA/DCSID/ESID BORDEAUX	98
AGENCE DE L'EAU ADOUR-GARONNE	AGENCE DE L'EAU ADOUR GARONNE	100
DÉPARTEMENT DE LA LOZÈRE, CD 48	DÉPARTEMENT DE LA LOZÈRE — CD 48	98
CCI LYON MÉTROPOLE ST ÉTIENNE ROANNE	CCI LYON MÉTROPOLE SAINT-ÉTIENNE ROANNE	96
GRPEMENT DE CDES DES ÉTABLISSEMENTS	GROUPEMENT DE CDES DES ÉTABLISSEMENTS	97
CENTRE HOSPITALIER DU CENTRE-BRETAGNE	CENTRE HOSPITALIER CENTRE BRETAGNE	96
MAIRIE DE LA VERRIÈRE	MAIRIE DE LA VERRIERE	98
ASSOCIATION FRANÇAISE DE NORMALISATION: AFNOR	ASSOCIATION FRANCAISE DE NORMALISATION: AFNOR	99
COMMUNAUTÉ AGGLOMÉRATION BOURG-EN-BRESSE	COMMUNAUTÉ D'AGGLOMÉRATION BOURG-EN-BRESSE	97
EDF SA — DIRECTION DES ACHATS	EDF SA DIRECTION DES ACHATS	96
EDF — PRODUCTION ÉLECTRIQUE INSULAIRE — SAS (EDF PEI)	EDF PRODUCTION ÉLECTRIQUE INSULAIRE SAS (EDF PEI)	96
VILLE DE DEUIL LA BARRE	VILLE DE DEUIL-LA-BARRE	100
CONSEIL GÉNÉRAL DU PUY-DE-DÔME	CONSEIL GÉNÉRAL DU PUY DE DÔME	100
SOCIETÉ DES AUTOROUTES PARIS RHIN RHÔNE	SOCIÉTÉ DES AUTOROUTES PARIS-RHIN-RHÔNE	99
COMMUNAUTÉ ARTOIS-LYS	COMMUNAUTE ARTOIS-LYS	98
DIRECTION DÉPARTEMENTALE FIN PUB 93	DIRECTION DÉPARTEMENTALE FIN. PUB. 93	97
TARN-ET-GARONNE HABITAT	TARN ET GARONNE HABITAT	100
MINDEF/ARMÉE DE L'AIR/SIMMAD/SSAM 33503	MINDEF/ARMÉE DE L'AIR/SIMMAD/SSAM33503	99
SA AÉROPORT MONTPELLIER MÉDITERRANÉE	SA AÉROPORT MONTPELLIER-MÉDITERRANÉE	100
CHI ELBEUF LOUVIERS / VAL DE REUIL	CHI ELBEUF-LOUVIERS / VAL DE REUIL	100
CONSEIL GÉNÉRAL DE SEINE SAINT-DENIS	CONSEIL GÉNÉRAL DE SEINE SAINT DENIS	100
ÉCOLE NATIONALE SUPÉRIEURE DE CHIMIE MONTPELLIER	ÉCOLE NATIONALE SUPÉRIEURE DE CHIMIE DE MONTPELLIER	97
SMICVAL DU LIBOURNAIS HAUTE GIRONDE	SMICVAL DU LIBOURNAIS HAUTE-GIRONDE	100
CA CHALON-VAL DE BOURGOGNE	CA CHALON VAL DE BOURGOGNE	100
GCS TÉLÉSANTÉ BASSE-NORMANDIE	GCS TÉLÉSANTÉ BASSE NORMANDIE	100
URSSAF DE PARIS-RÉGION PARISIENNE	URSSAF DE PARIS — RÉGION PARISIENNE	97
CENTRE HOSPITALIER DE SAINT MARTIN	CENTRE HOSPITALIER DE SAINT-MARTIN	100
GIE GROUPE SNI SYSTÈMES D'INFORMATION	GIE GROUPE SNI SYSTEMES D'INFORMATION	99
EP MÉDICO-SOCIAL D'AMIENS	EP MÉDICO SOCIAL D'AMIENS	100
COMMUNAUTÉ D’AGGLOMÉRATION ORLÉANS VAL DE LOIRE	COMMUNAUTÉ D'AGGLOMÉRATION ORLÉANS VAL DE LOIRE	100
MÉTROPOLE NICE-CÔTE D'AZUR	MÉTROPOLE NICE CÔTE D'AZUR	100
CHI TOULON — LA SEYNE-SUR-MER	CHI TOULON, LA SEYNE-SUR-MER	98
COLLECTIVITE TERRITORIALE MARTINIQUE	COLLECTIVITÉ TERRITORIALE MARTINIQUE	99
SILÈNE	SILNE	100
OP HLM DE DRANCY	OPHLM DE DRANCY	97
COMMUNAUTÉ D'AGGLOMÉRATION LA PORTE DU HAINAUT	COMMUNAUTÉ D'AGGLOMÉRATION DE LA PORTE DU HAINAUT	97
SYNDICAT DES EAUX D'ÎLE-DE-FRANCE	SYNDICAT DES EAUX D'ILE-DE-FRANCE	98
UNIVERSITÉ JEAN-MOULIN-LYON 3	UNIVERSITÉ JEAN MOULIN LYON 3	100
MINISTÈRE ÉCONOMIE, FINANCES, INDUSTRIE	MINISTÈRE ÉCONOMIE FINANCES INDUSTRIE	97
CENTRE HOSPITALIER DÉPARTEMENTAL STELL	CENTRE HOSPITALIER DÉPARTEMENT STELL	97
UGECAM NORD-PAS-DE-CALAIS — PICARDIE	UGECAM NORD PAS-DE-CALAIS-PICARDIE	97
CHD LA ROCHE-SUR-YON — LUÇON — MONTAIGU	CHD LA ROCHE-SUR-YON - LUÇON - MONTAIGU	100
UNIVERSITÉ MICHEL DE MONTAIGNE BORDEAU	UNIVERSITÉ MICHEL-DE-MONTAIGNE-BORDEAU	100
AÉROPORT DE TOULOUSE-BLAGNAC	AÉROPORT DE TOULOUSE BLAGNAC	100
UNIVERSITÉ GRENOBLE ALPES	UNIVERSITÉ GRENOBLE-ALPES	100
CHI VILLENEUVE-SAINT-GEORGES	CHI VILLENEUVE-SAINT GEORGES	100
BATIGÈRE ILE-DE-FRANCE	BATIGÈRE ILE DE FRANCE	100
LA NANTAISE D' HABITATIONS	LA NANTAISE D'HABITATIONS	98
URSSAF DE PARIS — RÉGION PARISIENNE	URSSAF DE PARIS-RÉGION PARISIENNE	97
COMMUNAUTÉ DE COMMUNES DU CANTON DE MONTLUEL	COMMUNAUTÉ COMMUNES DU CANTON DE MONTLUEL	96
CA COMMUNAUTÉ PARIS-SACLAY	CA COMMUNAUTÉ PARIS SACLAY	100
BANQUE DE FRANCE - DIRECTION DES ACHATS	BANQUE DE FRANCE — DIRECTION DES ACHATS	100
CEA — CENTRE DE CADARACHE	CEA, CENTRE DE CADARACHE	98
COMMUNAUTTÉ D'AGGLOMÉRATION DU BASSIN DE THAU	COMMUNAUTÉ D'AGGLOMÉRATION DU BASSIN DE THAU	99
LANGUEDOC-ROUSSILLON AMÉNAGEMENT	LANGUEDOC ROUSSILLON AMÉNAGEMENT	100
DEA976-SIST-UST	DEA 976-SIST-UST	97
COMMUNAUTÉ COMMUNES DU SUD TERRITOIRE	COMMUNAUTÉ DE COMMUNES DU SUD TERRITOIRE	96
TRAMCITES-GPT EGIS RAIL / NORMANDIE-AMÉN	TRAMCITES-GPT EGIS RAIL/NORMANDIE-AMÉN	97
URSSAF HAUTE-NORMANDIE	URSSAF HAUTE NORMANDIE	100
VALOPHIS HABITAT — OPH DU VAL DE MARNE	VALOPHIS HABITAT — OPH DU VAL-DE-MARNE	100
CONSEIL GÉNÉRAL D'EURE ET LOIR	CONSEIL GÉNÉRAL D'EURE-ET-LOIR	100
VILLE DE MONTCEAU-LES-MINES	VILLE DE MONCEAU-LES-MINES	98
UNIVERSITÉ JEAN MOULIN LYON 3	UNIVERSITÉ JEAN-MOULIN-LYON 3	100
COMMUNAUTÉ D'AGGLOMÉRATION LIMOGES MÉTROPOLE	COMMUNAUTÉ D’AGGLOMÉRATION LIMOGES MÉTROPOLE	100
COMMUNAUTÉ D'AGGLOMÉRATRION DU SOISSONNAIS	COMMUNAUTÉ D'AGGLOMÉRATION DU SOISSONNAIS	99
COMMUNAUTÉ D'AGGLOMÉRATION ORLÉANS VAL DE LOIRE	COMMUNAUTÉ D’AGGLOMÉRATION ORLÉANS VAL DE LOIRE	100
COMUNNAUTÉ D'AGGLOMÉRATION CHÂTEAUROUX MÉTROPOLE	COMMUNAUTÉ D'AGGLOMÉRATION CHÂTEAUROUX MÉTROPOLE	98
CH PAYS D'AIX — CHI AIX-PERTUIS	CH PAYS AIX — CHI AIX PERTUIS	97
CONSEIL GÉNÉRAL DE SEINE SAINT DENIS	CONSEIL GÉNÉRAL DE SEINE SAINT-DENIS	100
COMMUNAUTÉ DE COMMUNES OSARTIS-MARQUION	COMMUNAUTÉ DE COMMUNES OSARTIS MARQUION	100
COMMUNAUTÉ D'AGGLOMÉRATION DU GRAND DOLE	COMMUNAUTÉ D’AGGLOMÉRATION DU GRAND DOLE	100
COMMUNAUTÉ D'AGGLOMÉRATION DU PAYS DE FLERS	COMMUNAUTÉ D’AGGLOMÉRATION DU PAYS DE FLERS	100
EP MÉDICO SOCIAL D'AMIENS	EP MÉDICO-SOCIAL D'AMIENS	100
DÉPARTEMENT DES PYRÉNÉES ORIENTALES	DÉPARTEMENT DES PYRÉNÉES-ORIENTALES	100
ESCOTA — SOCIÉTÉ DES AUTOROUTES ESTEREL — CÔTE D'AZUR — PROVENCE — ALPES	ESCOTA — SOCIÉTÉ DES AUTOROUTES ESTÉREL, CÔTE D'AZUR, PROVENCE, ALPES	97
SI ENERGIES DE MAINE-ET-LOIRE	SI ÉNERGIES DE MAINE-ET-LOIRE	98
CENTRE HOSPITALIER DR. RÉCAMIER	CENTRE HOSPITALIER DR RÉCAMIER	98
VILLE DE LA GRANDE-MOTTE	VILLE DE LA GRANDE MOTTE	100
RÉGION PROVENCE-ALPES-CÔTE D'AZUR	RÉGION PROVENCE ALPES CÔTE D'AZUR	100
ÉTABLISSEMENT MÉDICO SOCIAL	ÉTABLISSEMENT MÉDICO-SOCIAL	100
CENTRE HOSPITALIER DE RIVES	CENTRE HOSPITALIER DE BRIVE	96
COMMUNAUTÉ D'AGGLOMÉRATION SOPHIA ANTIPOLIS	COMMUNAUTÉ AGGLOMÉRATION SOPHIA-ANTIPOLIS	98
CENTRE HOSPITALIER DÉPARTEMENT STELL	CENTRE HOSPITALIER DÉPARTEMENTAL STELL	97
VILLE DE QUÉTIGNY	VILLE DE QUETIGNY	97
CC DE SAINT-DIÉ-DES-VOSGES	CH DE SAINT-DIÉ-DES-VOSGES	96
CNRS DÉLÉGATION CENTRE EST	CNRS-DÉLÉGATION CENTRE EST	100
CHD LA ROCHE-SUR-YON LUÇON-MONTAIGU	CHD LA ROCHE-SUR-YON-LUÇON-MONTAIGU	100
MONTPELLIER MÉDITERRANNÉE MÉTROPOLE	MONTPELLIER MÉDITERRANÉE MÉTROPOLE	98
ÉTABLISSEMENT PUBLIC MUSÉES ORSAY ET ORANGERIE	ÉTABLISSEMENTS PUBLIC MUSÉES ORSAY ET ORANGERIE	99
ŒUVRE DU PERPÉTUEL SECOURS — IHFB	ŒUVRE DU PERPÉTUEL SECOURS IHFB	97
GROUPE HOSPITALIER SECLIN CARVIN	GROUPE HOSPITALIER SECLIN-CARVIN	100
INSTITUT NATIONAL DES JEUNES SOURDS	INSTITUT NATIONAL DE JEUNES SOURDS	99
[LA POSTE] DIRECTION DES ACHATS DE LA BRANCHE SERVICES COURRIER — COLIS	[LA POSTE] DIRECTION DES ACHATS — BRANCHE SERVICES-COURRIER-COLIS	96
VILLE, EUROMÉTROPOLE DE STRASBOURG	VILLE EUROMÉTROPOLE DE STRASBOURG	98
CNRS — DÉLÉGATION MIDI PYRÉNÉES	CNRS — DÉLÉGATION MIDI-PYRÉNÉES	100
SNI SUD EST	SNI SUD-EST	100
COMMUNAUTÉ DE COMMUNES PAYS D'HÉRICOURT	COMMUNAUTÉ COMMUNES PAYS D'HÉRICOURT	96
OPAC SAÔNE ET LOIRE — OFFICE PUBLIC DE L'HABITAT	OPAC SAÔNE-ET-LOIRE — OFFICE PUBLIC DE L'HABITAT	100
DEPARTEMENT DE L'AISNE	DÉPARTEMENT DE L'AISNE	98
RÉGION LANGUEDOC-ROUSSILLON-MIDI-PYRENEES	RÉGION LANGUEDOC-ROUSSILLON-MIDI-PYRÉNÉES	97
UNIVERSITÉ TOULOUSE II — JEAN JAURÈS	UNIVERSITÉ TOULOUSE II — JEAN JAURES	99
LA POSTE – DIRECTION GÉNÉRALE DU RÉSEAU	LA POSTE — DIRECTION GÉNÉRALE DU RÉSEAU	100
MARINE/DCSSF/DSSF BREST	MARINE/DCSSF/ DSSF BREST	98
COMMUNAUPÔLE DE LENS-LIÉVIN	COMMUNAUPOLE DE LENS-LIÉVIN	98
COMMUNAUTÉ DE COMMUNES CÔTE DE PENTHIÈVRE	COMMUNAUTÉ DES COMMUNES CÔTE DE PENTHIÈVRE	99
COMMUNAUTÉ D'AGGLOMÉRATION GRAND VERDUN	COMMUNAUTÉ AGGLOMÉRATION GRAND VERDUN	97
ÉCOLE NATIONAL SUPÉRIEURE D'ARTS ET MÉTIERS	ÉCOLE NATIONALE SUPÉRIEURE D'ARTS ET MÉTIERS	99
VILLE DU PRÉ-SAINT-GERVAIS	VILLE DU PRÉ SAINT-GERVAIS	100
CPAM DU HAUT-RHIN	CPAM DU HAUT-RHI	97
DÉPARTEMENT DES PYRÉNÉES-ORIENTALES	DÉPARTEMENT DES PYRÉNÉES ORIENTALES	100
RÉGION NORD-PAS-DE-CALAIS — PICARDIE	RÉGION NORD-PAS-DE-CALAIS - PICARDIE	100
SOCIÉTÉ NATIONALE IMMOBILIÈRE — ÉTABLISSEMENT NORD EST	SOCIÉTÉ NATIONALE IMMOBILIÈRE — ÉTABLISSEMENT NORD-EST	100
COMMUNAUTÉ AGGLOMÉRATION CHARLEVILLE-MÉZIÈRES / SEDAN	COMMUNAUTÉ AGGLOMÉRATION CHARLEVILLE-MÉZIÈRES/ SEDAN	99
COMMUNAUTÉ D'AGGLOMÉRATION DE SOPHIA ANTIPOLIS	COMMUNAUTÉ D'AGGLOMÉRATION SOPHIA ANTIPOLIS	96
COMMUNAUTÉ DE COMMUNES PÉVÈLE CAREMBAULT	COMMUNAUTÉ COMMUNES PÉVÈLE CAREMBAULT	96
[LA POSTE] BRANCHE SERVICES-COURRIER-COLIS (BSCC), FILIALE VIAPOST TRANSPORT MANAGEMENT	[LA POSTE] BRANCHE SERVICES-COURRIER-COLIS (BSCC) — FILIALE VIAPOST TRANSPORT MANAGEMENT	99
CCI RÉGION PARIS ÎLE-DE-FRANCE	CCI REGION PARIS ÎLE-DE-FRANCE	98
URSSAF HAUTE NORMANDIE	URSSAF HAUTE-NORMANDIE	100
GRAND ANGOULÊME AGGLOMÉRATION	GRANDANGOULÊME AGGLOMÉRATION	98
EDF SA — DIRECTION DES ACHATS — ARAP GRAND OUEST	EDF SA DIRECTION DES ACHATS ARAP GRAND OUEST	96
MINISTÈRE DE L'INTERIEUR	MINISTÈRE DE L'INTÉRIEUR	98
SYNDICAT MIXTE DÉPARTEMENTAL DE LA VOIRIE DES COMMUNES DE CHARENTE-MARITIME	SYNDICAT MIXTE DÉPARTEMENTAL DE LA VOIRIE DES COMMUNES DE LA CHARENTE-MARITIME	98
COMMUNAUTÉ D’AGGLOMÉRATION LIMOGES MÉTROPOLE	COMMUNAUTÉ D'AGGLOMÉRATION LIMOGES MÉTROPOLE	100
CNRS-DÉLÉGATION CENTRE EST	CNRS DÉLÉGATION CENTRE EST	100
LOCMINÉ COMMUNAUTÉ	LOCMINE COMMUNAUTÉ	97
UNIVERSITÉ PARIS-SUD	UNIVERSITÉ PARIS SUD	100
TERRITOIRE DE LA CÔTE OUEST	TERRITOIRE DE LA COTE OUEST	98
RÉGION NORD-PAS-DE-CALAIS-PICARDIE	RÉGION NORD PAS-DE-CALAIS-PICARDIE	100
CEA COMMISSARIAT À L'ÉNERGIE ATOMIQUE ET AUX ÉNERGIES ALTERNATIVES — CEA/DAM ÎLE-DE-FRANCE	COMMISSARIAT À L'ÉNERGIE ATOMIQUE ET AUX ÉNERGIES ALTERNATIVES — CEA/DAM/ ÎLE-DE-FRANCE	97
COMMUNE DE MONT DE LANS	COMMUNE DE MONT-DE-LANS	100
LA CITÉ, LE CENTRE DES CONGRÈS DE NANTES	LA CITÉ LE CENTRE DES CONGRÈS DE NANTES	99
BATIGERE SAREL	BATIGÈRE SAREL	96
PLATE FORME ACHATS FINANCES NORD-EST	PLATE-FORME ACHATS FINANCES NORD EST	100
GROUPEMENTS DE COMMANDES	GROUPEMENT DE COMMANDES	98
CC AVRANCHES – MONT-SAINT-MICHEL	CC AVRANCHES - MONT-SAINT-MICHEL	100
MAIRIE DE TREMBLAY-EN-FRANCE	MAIRIE DE TREMBLAY EN FRANCE	100
CNIEL — INTERPROFESSION LAITIÈRE FRANÇAISE	CNIEL INTERPROFESSION LAITIÈRE FRANÇAISE	97
ESH «UN TOIT POUR TOUS»	ESH UN TOIT POUR TOUS	98
ORVITIS SERVICE MARCHÉS	ORVITIS — SERVICE MARCHÉS	96
PÔLE EMPLOI CENTRE VAL DE LOIRE	PÔLE EMPLOI CENTRE-VAL DE LOIRE	100
CCI DE NÎMES BAGNOLS UZÈS LE VIGAN	CCI DE NÎMES-BAGNOLS-UZÈS-LE VIGAN	100
INSTITUT NATIONAL DE JEUNES SOURDS	INSTITUT NATIONAL DES JEUNES SOURDS	99
PLATEFORME ACHATS FINANCES NORD EST	PLATE FORME ACHATS FINANCES NORD-EST	99
LOGÉAL IMMOBILIÈRE	LOGEAL IMMOBILIÈRE	97
PRÉFECTURE DE POLICE — DFCPP BCP	PRÉFECTURE DE POLICE DFCPP BCP	97
SA D'HLM AIGUILLON CONSTRUCTION	SA D' HLM AIGUILLON CONSTRUCTION	98
CH DE SAINT-DIÉ-DES-VOSGES	CC DE SAINT-DIÉ-DES-VOSGES	96
PLATE-FORME ACHATS FINANCES NORD EST	PLATE FORME ACHATS FINANCES NORD-EST	100
STE-PÉRINE — ROSSINI — CHARDON-LAGACHE	SAINTE PÉRINE — ROSSINI — CHARDON LAGACHE	96
CONSEIL GÉNÉRAL DES PYRÉNÉES-ATLANTIQUES	CONSEIL GAL DES PYRÉNÉES-ATLANTIQUES	97
CENTRE DE GESTION DE LA FPT 76	CENTRE DE GESTION DE LA FPT 77	97
CC MATHEYSINE PAYS CORPS-VALLEES VALBO	CC MATHEYSINE PAYS CORPS VALLÉES VALBON	97
SA HLM PICARDIE HABITAT	SA HLM — PICARDIE HABITAT	96
GEIE TUNNEL DU MT BLANC	GEIE TUNNEL DU MONT-BLANC	96
DESTINATION RENNES TOURISME CONGRÈS	DESTINATION RENNES — TOURISME CONGRÈS	97
VILLE DE CORMEILLES EN PARISIS	VILLE DE CORMEILLES-EN-PARISIS	100
BÂTIPLAINE SOCIÉTÉ DE COORDINATION	BÂTIPLAINE — SOCIÉTÉ DE COORDINATION	97
DISP EST-STRASBOURG	DISP EST STRASBOURG	100
COMMUNAUTÉ D'AGGLOMÉRATION BÉZIERS MÉDITERRANÉE	COMMUNAUTÉ D'AGGLOMÉRATION BÉZIERS-MÉDITERRANÉE	100
VILLE DE BOURG-SAINT MAURICE-ARCS	VILLE DE BOURG-SAINT-MAURICE — ARCS	97
VAL DE SEINE AMÉNAGEMENT	VAL-DE-SEINE AMÉNAGEMENT	100
COMMUNAUTÉ DE COMMUNES DU PETIT CAUX	COMMUNAUTÉ DE COMMUNES DU PETIT-CAUX	100
CONSEIL RÉGIONAL LANGUEDOC-ROUSSILLON	CONSEIL RÉGIONAL LANGUEDOC ROUSSILLON	100
VILLE DE QUETIGNY	VILLE DE QUÉTIGNY	97
CENTRE HOSPITALIER A.GUÉRIN	CENTRE HOSPITALIER A. GUÉRIN	98
COMMUANUTÉ D'AGGLOMÉRATION DU SOISSONNAIS	COMMUNAUTÉ D'AGGLOMÉRATION DU SOISSONNAIS	97
[LA POSTE] DIRECTION DES ACHATS — BRANCHE SERVICES-COURRIER-COLIS	[LA POSTE] DIRECTION DES ACHATS, BRANCHE SERVICES-COURRIER-COLIS	99
COMMUNAUTÉ DE COMMUNES DU SUD TERRITOIRE	COMMUNAUTÉ COMMUNES DU SUD TERRITOIRE	96
COMMUNAUTÉ DE COMMUNES ARC SUD BRETAGNE	COMMUNAUTÉ DE COMMUNES ARC SUD BRETAGN	99
UGECAM RHÔNE ALPES	UGECAM RHÔNE-ALPES	100
TUNNEL EURALPIN LYON TURIN SAS	TUNNEL EURALPIN LYON-TURIN SAS	100
MINDEF/SGA/SPAC/S-DIRECTION DES ACHATS	MINDEF/SGA/SPAC/S — DIRECTION DES ACHATS	97
INSTITUT NATIONAL DE RECHERCHE ET DE SECURITÉ POUR LA PRÉVENTION DES ACCIDENTS DU TRAVAIL ET DES MALADIES PROFESSIONNELLES (INRS)	INSTITUT NATIONAL DE RECHERCHE ET DE SECURITÉ POUR LA PRÉVENTION DES ACCIDENTS DU TRAVAIL ET DES MALADIES PROFESSIONELLES (INRS)	100
OPAC DE QUIMPER-CORNOUAILLE	OPAC DE QUIMPER CORNOUAILLE	100
GH DE LA HAUTE-SAÔNE	GH DE LA HAUTE SAÔNE	100
HOPITAUX CIVILS DE COLMAR	HÔPITAUX CIVILS DE COLMAR	98
SGAP SUD OUEST	SGAP SUD-OUEST	100
COMMUNAUTÉ D'AGGLOMÉRATION PRIVAS CENTRE ARDÈCHE	COMMUNAUTÉ AGGLOMÉRATION PRIVAS CENTRE ARDRÈCHE	97
SEDD MANDATAIRE CRBFC	SEDD MANDATAIRE CRFC	98
INSTITUT NATIONAL DE RECHERCHE ET DE SECURITÉ POUR LA PRÉVENTION DES ACCIDENTS DU TRAVAIL ET DES MALADIES PROFESSIONELLES (INRS)	INSTITUT NATIONAL DE RECHERCHE ET DE SECURITÉ POUR LA PRÉVENTION DES ACCIDENTS DU TRAVAIL ET DES MALADIES PROFESSIONNELLES (INRS)	100
ÉCOLE NATIONALE SUPÉRIEURE D'ARTS ET MÉTIERS	ÉCOLE NATIONAL SUPÉRIEURE D'ARTS ET MÉTIERS	99
UNIVERSITÉ PARIS SORBONNE	UNIVERSITÉ PARIS-SORBONNE	100
IMMOBILIÈRE 3F, DPRU	IMMOBILIÈRE 3F — DPRU	97
GIE SESAM-VITALE	GIE SESAM VITALE	100
VILLE DE CREIL	VILLE DE CRÉTEIL	97
MAISONS ET CITÉS — SOGINORPA	MAISONS ET CITÉS SOGINORPA	96
[LA POSTE] DIRECTION DES ACHATS — BRANCHE COURRIER COLIS SERVICES (BSCC)	[LA POSTE] DIRECTION DES ACHATS BRANCHE COURRIER COLIS SERVICES (BSCC)	99
COMMUNE DU PUY EN VELAY	COMMUNE DU PUY-EN-VELAY	100
GRENOBLE ALPES MÉTROPOLE	GRENOBLE ALPES-MÉTROPOLE	100
COMMUNAUTÉ D'AGGLOMÉRATION CHÂTEAUROUX MÉTROPOLE	COMUNNAUTÉ D'AGGLOMÉRATION CHÂTEAUROUX MÉTROPOLE	98
SFVP (SCES FUNÉRAIRES VILLE DE PARIS)	SFVP (SCES FUNÉRAIRES, VILLE DE PARIS)	99
MÉTROPOLE NICE CÔTE D'AZUR	MÉTROPOLE NICE-CÔTE D'AZUR	100
EPT GRAND PARIS SEINE OUEST	EPT GRAND PARIS-SEINE-OUEST	100
CNIEL INTERPROFESSION LAITIÈRE FRANÇAISE	CNIEL — INTERPROFESSION LAITIÈRE FRANÇAISE	97
CTRE NAT DE LA RECHERCHE SCIENTIFIQUE	CTRE NAT. DE LA RECHERCHE SCIENTIFIQUE	99
BATIGÈRE ILE DE FRANCE	BATIGÈRE ILE-DE-FRANCE	100
SAEML — CHEMINS DE FER DE LA CORSE	SAEML CHEMINS DE FER DE LA CORSE	97
OFFICE PUBLIC DE L’HABITAT DE L'AGGLOMÉRATION DE LA ROCHELLE	OFFICE PUBLIC DE L'HABITAT DE L'AGGLOMÉRATION DE LA ROCHELLE	100
CTRE INTERNATIONAL ÉTUDES PÉDAGOGIQUES	CENTRE INTERNATIONAL ÉTUDES PÉDAGOGIQUES	97
CC DE LA BRIE-CHAMPENOISE	CC DE LA BRIE CHAMPENOISE	100
PÔLE SANTÉ SARTHE ET LOIR	PÔLE SANTÉ SARTHE ET LOIRE	98
UNIVERSITÉ PARIS SUD	UNIVERSITÉ PARIS-SUD	100
CARSAT CENTRE-OUEST	CARSAT CENTRE OUEST	100
SYNDICAT DES EAUX D'ILE-DE-FRANCE	SYNDICAT DES EAUX D'ÎLE-DE-FRANCE	98
CENTRE ÉTUDES EXPERT SUR RISQUES ENVIR. M.	CENTRE ÉTUDES EXPERT SUR RISQUES ENVIR M	99
DÉPARTEMENT DE SEINE MARITIME	DÉPARTEMENT DE SEINE-MARITIME	100
SAEML CHEMINS DE FER DE LA CORSE	SAEML — CHEMINS DE FER DE LA CORSE	97
ÉLECTRICITÉ RÉSEAU DISTRIBUTION FRANCE (ERDF)	ÉLÉCTRICITÉ RÉSEAU DISTRIBUTION FRANCE (ERDF)	99
CNRS — DÉLÉGATION CENTRE LIMOUSIN POITOU-CHARENTES	CNRS — DÉLÉGATION CENTRE LIMOUSIN POITOU CHARENTES	100
CDC DE LA HAUTE-SAINTONGE	CDC DE LA HAUTE SAINTONGE	100
UNIVERSITÉ PARIS-EST CRÉTEIL	UNIVERSITÉ PARIS-EST-CRÉTEIL	100
CUS HABITAT — OFFICE PUBLIC DE L'HABITAT DE L'EUROMÉTROPOLE DE STRASBOURG	CUS HABITAT, OFFICE PUBLIC DE L'HABITAT DE L'EUROMÉTROPOLE DE STRASBOURG	99
SGAP SUD-OUEST	SGAP SUD OUEST	100
LE GROUPEMENT DE COMMANDES «PÔLE IMMOBILIER» REPRÉSENTÉ PAR POSTE IMMO EN QUALITÉ DE COORDONNATEUR	LE GROUPEMENT DE COMMANDES «PÔLE IMMOBILIER» REPRÉSENTÉ PAR POSTE IMMO, EN QUALITÉ DE COORDONNATEUR	98
CONSEIL RÉGIONAL DE PROVENCE-ALPES-CÔTE D'AZUR	CONSEIL RÉGIONAL PROVENCE-ALPES-CÔTE D'AZUR	96
CONSEIL ÉCONOMIQUE SOCIAL ENVIRONNEMEN	CONSEIL ÉCONOMIQUE SOCIAL ENVIRONNEMENTAL	96
LYC GAL ET TECHNOLOGIQU ROBERT SCHUMAN	LYC GAL. ET TECHNOLOGIQU ROBERT SCHUMAN	99
PLATE-FORME ACHATS FINANCES NORD-EST	PLATE FORME ACHATS FINANCES NORD-EST	100
SOCIÉTÉ IMMOBILIÈRE DES CHEMINS DE FER	SOCIÉTÉ IMMOBILIÈRE DES CHEMINS DE FERS	99
HU LA PITIE SALPETRIÈRE CHARLES FOIX	H-U LA PITIÉ-SALPÊTRIÈRE CHARLES FOIX	96
ENEDIS (ANCIENNEMENT ERDF — ÉLECTRICITÉ RÉSEAU DISTRIBUTION FRANCE)	ENEDIS (ANCIENNEMENT ERDF ÉLECTRICITÉ RÉSEAU DISTRIBUTION FRANCE)	98
COMMUNAUTÉ DE COMMUNES BRESLE-MARITIME	COMMUNAUTÉ DE COMMUNES BRESLE MARITIME	100
SDEA ALSACE-MOSELLE	SDEA ALSACE MOSELLE	100
COMMUNE DU PUY-EN-VELAY	COMMUNE DU PUY EN VELAY	100
COMMUNAUTÉ DE COMMUNES DU PAYS DE FAYENCE	COMMUNAUTÉ COMMUNES DU PAYS DE FAYENCE	96
CONSEIL INTERPROFESSIONNEL VINS PROVENCE	CONS INTERPROFESSIONNEL VINS PROVENCE	96
COMMUNE DE CHAMONIX MONT-BLANC	COMMUNE DE CHAMONIX-MONT-BLANC	100
SYNDICAT MIXTE LOT NUMÉRIQUE	SYNDICAT MIXTE LOT NUMERIQUE	98
GIE AGIRC-ARRCO	GIE AGIRC ARRCO	100
COMMUNAUTÉ AGGLOMÉRATION GRAND VERDUN	COMMUNAUTÉ D'AGGLOMÉRATION GRAND VERDUN	97
AGENCE DE MUTUALISATION DES UNIVERSITÉ	AGENCE DE MUTUALISATION DES UNIVERSITÉS	99
HABITAT EURELIEN	HABITAT EURÉLIEN	97
INSTITUT D'ETUDES POLITIQUES	INSTITUT D'ÉTUDES POLITIQUES	98
COMMUNAUTÉ D'AGGLOMÉRATION LA ROCHELLE	COMMUNAUTÉ D'AGGLOMERATION LA ROCHELLE	99
VILLE DE SAINTE-SAVINE	VILLE DE SAINTE SAVINE	100
COMMUNAUTÉ DE COMMUNES DU PAYS D'ÉVIAN	COMMUNAUTÉ DE COMMUNES DU PAYS D'EVIAN	99
BATIGÈRE SAREL	BATIGERE SAREL	96
SAINTE-PÉRINE — ROSSINI — CHARDON LAGACHE	SAINTE PÉRINE — ROSSINI — CHARDON LAGACHE	100
MINISTÈRE DE LA JUSTICE ET DES LIBÉRTÉ	MINISTÈRE DE LA JUSTICE ET DES LIBÉRTÉS	99
SA D' HLM AIGUILLON CONSTRUCTION	SA D'HLM AIGUILLON CONSTRUCTION	98
CPAM DU VAL DE MARNE	CPAM DU VAL-DE-MARNE	100
COMMUNAUTÉ D'AGGLOMÉRATION DU PAYS DE MONTBÉLIARD	COMMUNAUTÉ D’AGGLOMÉRATION DU PAYS DE MONTBÉLIARD	100
INSTITUT ROBERT MERLE D'AUBIGNÉ	INSTITUT ROBERT MERLE D'AUBIGNE	98
[LA POSTE] BRANCHE SERVICES COURRIER COLIS (BSCC) FILIALE VIAPOST TRANSPORT MANAGEMENT	[LA POSTE] BRANCHE SERVICES-COURRIER-COLIS (BSCC) FILIALE VIAPOST TRANSPORT MANAGEMENT	100
AGENCE DE L'EAU RMC	AGENCE DE L'EAU RM&C	97
DIRECTION DES ACHATS MAIRIE DE PARIS	DIRECTION DES ACHATS, MAIRIE DE PARIS	99
CHI TOULON-LA SEYNE-SUR-MER	CHI TOULON LA SEYNE-SUR-MER	100
LYCÉE PROFESSIONNEL EMILE ZOLA	LYCÉE PROFESSIONNEL ÉMILE ZOLA	98
INSTITUT PAOLI-CALMETTES	INSTITUT PAOLI CALMETTES	100
INSTITUT D'ÉTUDES POLITIQUES	INSTITUT D'ETUDES POLITIQUES	98
CENTRE RÉGIONAL DES ŒUVRES UNIVERSITAIRES ET SCOLAIRES	CENTRE RÉGIONAL DES OEUVRES UNIVERSITAIRES ET SCOLAIRES	97
LE GROUPEMENT DE COMMANDES «PÔLE IMMOBILIER» REPRÉSENTÉ PAR POSTE IMMO EN SA QUALITÉ DE COORDONNATEUR	LE GROUPEMENT DE COMMANDES «PÔLE IMMOBILIER» REPRÉSENTÉ PAR POSTE IMMO, EN QUALITÉ DE COORDONNATEUR	97
MUSÉUM NATIONAL D'HISTOIRE NATURELLE	MUSEUM NATIONAL D'HISTOIRE NATURELLE	99
ÉTABLISSEMENT FRANÇAIS DU SANG CENTRE ATLANTIQUE	ÉTABLISSEMENT FRANÇAIS DU SANG, CENTRE ATLANTIQUE	99
ÉTABLISSEMENTS PUBLIC MUSÉES ORSAY ET ORANGERIE	ÉTABLISSEMENT PUBLIC MUSÉES ORSAY ET ORANGERIE	99
COMMUNAUTÉ D’AGGLOMÉRATION DE PAU PYRÉNÉES	COMMUNAUTÉ D'AGGLOMÉRATION DE PAU PYRÉNÉES	100
CCI LYON MÉTROPOLE SAINT-ÉTIENNE ROANNE	CCI LYON MÉTROPOLE ST ÉTIENNE ROANNE	96
COMMUNAUTÉ D’AGGLOMÉRATION DU PAYS DE MONTBÉLIARD	COMMUNAUTÉ D'AGGLOMÉRATION DU PAYS DE MONTBÉLIARD	100
SAEML NANTES-MÉTROPOLE GESTION ÉQUIPEMENTS	SAEML NANTES-MÉTROPOLE, GESTION ÉQUIPEMENTS	99
AGENCE DE L'EAU ARTOIS — PICARDIE	AGENCE DE L'EAU ARTOIS-PICARDIE	97
CARSAT RHÔNE ALPES	CARSAT RHÔNE-ALPES	100
COMMUNAUTÉ D'AGGLOMÉRATION DE METZ	COMMUNAUTÉ D’AGGLOMÉRATION DE METZ	100
LYCÉE ÉDMOND PERRIER	LYCÉE EDMOND PERRIER	97
PAS-DE-CALAIS HABITAT	PAS DE CALAIS HABITAT	100
COMMUNAUTÉ COMMUNES ARDENNES RIVES DE MEUSE	COMMUNAUTÉ DE COMMUNES ARDENNES RIVES DE MEUSE	97
UNIVERSITÉ PARIS-OUEST-NANTERRE	UNIVERSITÉ PARIS OUEST NANTERRE	100
OPAC SAÔNE-ET-LOIRE — OFFICE PUBLIC DE L'HABITAT	OPAC SAÔNE ET LOIRE — OFFICE PUBLIC DE L'HABITAT	100
VILLE DE MONCEAU-LES-MINES	VILLE DE MONTCEAU-LES-MINES	98
L'HÔPITAL NORD FRANCHE-COMTÉ	L'HOPITAL NORD FRANCHE-COMTÉ	98
COMITÉ RÉGIONAL DU TOURISME DE BOURGOGNE	COMITÉ RÉGIONAL DU TOURISME DE BOURGOG	97
SOC MIXTE AMÉNAG VILLE LAMENTIN	SOC MIXTE AMENAG VILLE LAMENTIN	98
[LA POSTE] DIRECTION DES ACHATS, BRANCHE SERVICES-COURRIER-COLIS	[LA POSTE] DIRECTION DES ACHATS BRANCHE SERVICES COURRIER COLIS	99
CONSEIL GÉNÉRAL DE SEINE-SAINT-DENIS	CONSEIL GÉNÉRAL DE SEINE SAINT-DENIS	100
UNIVERSITÉ DENIS DIDEROT-PARIS 7	UNIVERSITÉ DENIS DIDEROT — PARIS 7	97
CH PAYS AIX — CHI AIX-PERTUIS	CH PAYS AIX — CHI AIX PERTUIS	100
SYCTOM DU LOIRE BÉCONNAIS	SYCTOM DU LOIRE-BÉCONNAIS	100
SAS LE RICHEMONT	SAS LERICHEMONT	97
SYCTOM DU LOIRE-BÉCONNAIS	SYCTOM DU LOIRE BÉCONNAIS	100
GPM DE NANTES — SAINT-NAZAIRE	GPM DE NANTES-SAINT-NAZAIRE	96
DÉPARTEMENT DES CÔTES D'ARMOR	DÉPARTEMENT DES CÔTES-D'ARMOR	100
SYNDICAT MIXTE LOT NUMERIQUE	SYNDICAT MIXTE LOT NUMÉRIQUE	98
COMMUNAUTÉ D'AGGLOMÉRATION DE CHÂLONS-EN-CHAMPAGNE	COMMUNAUTÉ D’AGGLOMÉRATION DE CHÂLONS-EN-CHAMPAGNE	100
COMMUNAUTÉ DE COMMUNES DU NORD DU BASSIN DE THAU	COMMUNAUTÉ DE COMMUNES NORD DU BASSIN DE THAU	97
LYC GAL. ET TECHNOLOGIQU ROBERT SCHUMAN	LYC GAL ET TECHNOLOGIQU ROBERT SCHUMAN	99
GH COCHIN — BROCA — HÔTEL-DIEU	GH COCHIN — BROCA- HÔTEL-DIEU	98
MANTES EN YVELINES HABITAT	MANTES-EN-YVELINES HABITAT	100
VALOPHIS HABITAT — OPH VAL-DE-MARNE	VALOPHIS HABITAT, OPH VAL-DE-MARNE	99
SAEML NANTES-METROPOLE GESTION EQUIPEMENTS	SAEML NANTES-MÉTROPOLE GESTION ÉQUIPEMENTS	98
PLATE FORME ACHATS FINANCES NORD EST	PLATE FORME ACHATS FINANCES NORD-EST	100
AÉROPORT DE TOULOUSE BLAGNAC	AÉROPORT DE TOULOUSE-BLAGNAC	100
COMMUNAUTÉ D’AGGLOMÉRATION DE LA ROCHELLE	COMMUNAUTÉ D'AGGLOMÉRATION DE LA ROCHELLE	100
CHD DE LA CANDELIE	CHD DE LA CANDÉLIE	97
DÉPARTEMENT DE LA LOZÈRE CD 48	DÉPARTEMENT DE LA LOZÈRE, CD 48	98
COMMUNAUTÉ D'AGGLOMÉRATION DU PAYS DE MEAUX	COMMUNAUTÉ D’AGGLOMÉRATION DU PAYS DE MEAUX	100
MAISONS ET CITÉS/SOGINORPA	MAISONS ET CITÉS SOGINORPA	100
CENTRE HOSPITALIER DE MONTÉRAN	CENTRE HOSPITALIER DE MONTERAN	98
DREAL5962 SG	DREAL 5962 SG	96
UNIVERSITÉ DE HAUTE-ALSACE	UNIVERSITÉ DE HAUTE ALSACE	100
RGIE DES TRANSPORTS DE CARBONNE	RÉGIE DES TRANSPORTS DE CARBONNE	100
MAIRIE DE BOLLÈNE	MAIRIE DE BOLLÃ-NE	97
REIMS-HABITAT CHAMPAGNE ARDENNE	REIMS-HABITAT CHAMPAGNE-ARDENNE	100
MARNE ET CHANTEREINE HABITAT	MARNE-ET-CHANTEREINE HABITAT	100
VILLE DU PRÉ SAINT-GERVAIS	VILLE DU PRÉ-SAINT-GERVAIS	100
NÉOLIA LORRAINE	NEOLIA LORRAINE	97
CEA, COMMISSARIAT À L'ÉNÉRGIE ATOMIQUE ET AUX ÉNERGIES ALTERNATIVES	CEA (COMMISSARIAT À L'ÉNERGIE ATOMIQUE ET AUX ÉNERGIES ALTERNATIVES)	99
UNIVERSITÉ DE BRETAGNE SUD	UNIVERSITÉ DE BRETAGNE-SUD	100
CNRS — DÉLÉGATION CÔTE D'AZUR	CNRS — DÉLEGATION CÔTE D'AZUR	98
VILLE DE SAINT-BENOIT	VILLE DE SAINT-BENOÎT	98
DÉPARTEMENT DU VAL DE MARNE	DÉPARTEMENT DU VAL-DE-MARNE	100
COMMUNE DE MAUVES-SUR-LOIRE	COMMUNE DE MAUGES-SUR-LOIRE	96
VILLE DE VAL-D'ISÈRE	VILLE DE VAL D'ISÈRE	100
DÉPARTEMENT DE LA LOZÈRE CG 48	DÉPARTEMENT DE LA LOZÈRE CD 48	96
SOC ÉTUDE, MAITRISE, OUVRAGE, AMÉNAGEMENT	SOC ÉTUDE MAITRISE, OUVRAGE, AMÉNAGEMENT	99
CENTRE RÉGIONAL OEUVRES UNIV. SCOLAIRES	CENTRE RÉGIONAL ŒUVRES UNIV. SCOLAIRES	96
MIN. DÉFENSE-DCSID-SNIA	MIN.DÉFENSE-DCSID-SNIA	98
DIRECTION DES ACHATS, MAIRIE DE PARIS	DIRECTION DES ACHATS MAIRIE DE PARIS	99
ADEME — AGENCE DE L'ENVIRONNEMENT ET DE LA MAÎTRISE DE L'ÉNERGIE	ADEME — AGENCE DE L'ENVIRONNEMENT ET DE LA MAÎTRISE DE L'ENERGIE	99
AGENCE DE L'EAU RM&C	AGENCE DE L'EAU RMC	97
COMMUNAUTÉ DE COMMUNES DU CANTON DE RI	COMMUNAUTÉ DE COMMUNES DU CANTON DE PI	97
GRENOBLE-ALPES MÉTROPOLE	GRENOBLE ALPES-MÉTROPOLE	100
RTE — RÉSEAU DE TRANSPORT D'ELECTRICITÉ	RTE — RÉSEAU DE TRANSPORT D'ÉLECTRICITÉ	99
ARCHIPEL HABITAT — OPH DE RENNES MÉTROPOLE	ARCHIPEL HABITAT OPH DE RENNES MÉTROPOLE	98
MANTES-EN-YVELINES HABITAT	MANTES EN YVELINES HABITAT	100
MINISTÈRE DE L'INTERIEUR DSIC/SDAGA/BA	MINISTÈRE DE L'INTÉRIEUR DSIC/SDAGA/BA	99
COMMUNAUTÉ DE COMMUNES GRANVILLE, TERRE ET MER	COMMUNAUTÉ DE COMMUNES DE GRANVILLE, TERRE ET MER	97
SYNDICAT MIXTE NORD DAUPHINÉ	SYNDICAT MIXTE NORD DAUPHINE	98
INST. RECHERCHE TECHNOLOGIQUE AERN ESPA	INST RECHERCHE TECHNOLOGIQUE AERN ESPA	99
DÉPARTEMENT D'ILLE-ET-VILAINE	DÉPARTEMENT D'ILLE ET VILAINE	100
COMMUNAUTÉ D’AGGLOMÉRATION DE METZ	COMMUNAUTÉ D'AGGLOMÉRATION DE METZ	100
INRA ANGERS NANTES	INRA ANGERS-NANTES	100
VILLE DE LA GRANDE MOTTE	VILLE DE LA GRANDE-MOTTE	100
CENTRE HOSPITALIER DR RÉCAMIER	CENTRE HOSPITALIER DR. RÉCAMIER	98
COMMUNAUTÉ DE COMMUNES DU CENTRE LITTORAL	COMMUNAUTÉ DE COMMUES DU CENTRE LITTORAL	99
EPS ROGER PREVOT	EPS ROGER PRÉVOT	97
EDF SA DIRECTION DES ACHATS	EDF SA — DIRECTION DES ACHATS	96
LOGEMENT FRANCILIEN REPRÉSENTÉ PAR GIE LOGEMENT FRANCAIS	LOGEMENT FRANCILIEN REPRÉSENTÉ PAR GIE LOGEMENT FRANÇAIS	99
EDF SA — DIRECTION DES ACHATS AGENCE ACHAT THERMIQUE	EDF SA — DIRECTION DES ACHATS — AGENCE ACHATS THERMIQUE	97
CENTRE HOSPITALIER DE LENS	CENTRE HOSPITALIER DE SENS	96
DÉPARTEMENT DES BOUCHES-DU-RHÔNE	DÉPARTEMENT DES BOUCHES DU RHÔNE	100
[LA POSTE] DIRECTION DES ACHATS BRANCHE SERVICES-COURRIER-COLIS	[LA POSTE] DIRECTION DES ACHATS BRANCHE SERVICES COURRIER COLIS	100
CH DE CADILLAC-SUR-GARONNE	CH DE CADILLAC SUR GARONNE	100
SOCIÉTÉ IMMOBILIÈRE DU DÉPARTEMENT DE LA RÉUNION SOCIÉTÉ ANONYME D'ÉCONOMIE MIXTE (SEM) CRÉÉE EN APPLICATION DE L'ARTICLE 2 DE LA LOI DU 30.4.1946 AU CAPITAL DE 125 000 000 EUR — RCS SAINT DENIS N° 74 B 118 — SIRET: 310 863 592 00013	SOCIÉTÉ IMMOBILIÈRE DU DÉPARTEMENT DE LA RÉUNION SOCIÉTÉ ANONYME D'ECONOMIE MIXTE (SEM) CRÉÉE EN APPLICATION DE L'ARTICLE 2 DE LA LOI DU 30.4.1946 AU CAPITAL DE 125 000 000 EUR — RCS ST DENIS N°74 B 118 — SIRET :310 863 592 00013	99
VAL HAINAUT HABITAT	VAL' HAINAUT HABITAT	97
CA CHALON - VAL DE BOURGOGNE	CA CHALON VAL DE BOURGOGNE	96
MARINE/DCSSF/ DSSF BREST	MARINE/DCSSF/DSSF BREST	98
GUSTAVE ROUSSY	GUSTAVE-ROUSSY	100
CC AVRANCHES - MONT-SAINT-MICHEL	CC AVRANCHES – MONT-SAINT-MICHEL	100
PÔLE EMPLOI CENTRE-VAL DE LOIRE	PÔLE EMPLOI CENTRE VAL DE LOIRE	100
CENTRE HOSPITALIER DE BRETAGNE SUD	CENTRE HOSPITALIER DE BRETAGNE-SUD	100
RPA DREAL LANGUEDOC-ROUSSILLON-MIDI-PYRÉNÉES	RPA DREAL LANGUEDOC-ROUSSILLON-MIDI-PYRENÉES	99
UNIVERSITÉ ÉVRY-VAL-D'ESSONNE	UNIVERSITÉ ÉVRY VAL D'ESSONNE	100
EPS DE VILLE-EVRARD	EPS DE VILLE ÉVRARD	97
EPF ÎLE-DE-FRANCE	EPF ILE DE FRANCE	97
OPERA TOULON PROVENCE MEDITERRANÉE	OPÉRA TOULON PROVENCE MÉDITERRANÉE	97
MEDUANE HABITAT	MÉDUANE HABITAT	97
MISSION RÉGIONALE ACHATS MIDI PYRÉNÉES	MISSION RÉGIONALE ACHATS MIDI-PYRÉNÉES	100
MÉTROPOLE D'AIX MARSEILLE PROVENCE	MÉTROPOLE D'AIX-MARSEILLE PROVENCE	100
LA POSTE SACL — DOT ÎLE-DE-FRANCE	LA POSTE SACL — DOT ILE-DE-FRANCE	98
RÉGION ÎLE-DE-FRANCE	RÉGION ILE-DE-FRANCE	97
SOCIÉTÉ IMMOBILIÈRE DU DÉPARTEMENT DE LA RÉUNION SOCIÉTÉ ANONYME D'ÉCONOMIE MIXTE (SEM) CRÉÉE EN APPLICATION DE L'ARTICLE 2 DE LA LOI DU 30.4.1946 AU CAPITAL DE 125 000 000 EUR — RCS ST-DENIS N° 74 B 118 — SIRET: 310 863 592 00013	SOCIÉTÉ IMMOBILIÈRE DU DÉPARTEMENT DE LA RÉUNION SOCIÉTÉ ANONYME D'ÉCONOMIE MIXTE (SEM) CRÉÉE EN APPLICATION DE L'ARTICLE 2 DE LA LOI DU 30.4.1946 AU CAPITAL DE 125 000 000 EUR — RCS ST DENIS N°74 B 118 — SIRET :310 863 592 00013	100
CONSEIL ÉCONOMIQUE SOCIAL ENVIRONNEMENTAL	CONSEIL ÉCONOMIQUE SOCIAL ENVIRONNEMEN	96
GIE AGIRC ARRCO	GIE AGIRC-ARRCO	100
SIVOM SAINT-GAUDENS MONTRÉJEAU ASPET	SIVOM SAINT-GAUDENS MONTREJEAU ASPET	99
COMMUNAUTÉ D'AGGLOMÉRATION D'ÉPINAL-GOLBEY	COMMUNAUTÉ D'AGGLOMÉRATION ÉPINAL-GOLBEY	97
GIA PACA CPRSE AU NOM ET POUR LE COMPTE DE LA SNI SUD EST	GIE PACA CORSE AU NOM ET POUR LE COMPTE DE LA SNI SUD EST	96
CUS HABITAT OFFICE PUBLIC DE L'HABITAT DE L'EUROMÉTROPOLE DE STRASBOURG	CUS HABITAT, OFFICE PUBLIC DE L'HABITAT DE L'EUROMÉTROPOLE DE STRASBOURG	99
COMMUNAUTÉ COMMUNES COEUR DE TARENT	COMMUNAUTÉ COMMUNES CŒUR DE TARENT	96
